GEOID,pop_total,pop_white,housing_total,housing_owned,housing_rental,med_income,state,county,tract
36011040600,3400,3214,1257,1153,104,44333,36,011,040600
36011040700,3633,3553,1483,1387,96,40932,36,011,040700
36011040800,4668,3924,1528,1265,263,37585,36,011,040800
36011040900,3683,3615,1456,1270,186,38028,36,011,040900
36011041001,3088,2903,1192,996,196,30789,36,011,041001
36011041002,1650,1470,558,471,87,22083,36,011,041002
36011041101,2542,2508,1037,944,93,40625,36,011,041101
36011041102,1587,1579,588,462,126,32667,36,011,041102
36011041201,2294,2150,903,751,152,33734,36,011,041201
36011041202,2661,2579,1110,937,173,39014,36,011,041202
36011041300,3584,3180,1684,762,922,30568,36,011,041300
36011041400,4702,4259,2316,866,1450,32252,36,011,041400
36011041500,2698,2417,1201,648,553,30741,36,011,041500
36011041600,2610,2247,1036,717,319,40829,36,011,041600
36011041700,3907,3377,1920,1140,780,40377,36,011,041700
36011041800,4730,4121,1859,961,898,35233,36,011,041800
36011042100,4152,2404,1395,276,1119,21250,36,011,042100
36011990200,0,0,0,0,0,-666666666,36,011,990200
36013030100,3765,3165,1487,709,778,25084,36,013,030100
36013030200,4548,3875,1784,961,823,26713,36,013,030200
36013030300,1893,1238,854,398,456,20967,36,013,030300
36013030400,4309,3712,1922,1102,820,29753,36,013,030400
36013030500,3432,3009,1869,156,1713,20686,36,013,030500
36013030600,3533,3324,1507,717,790,28125,36,013,030600
36013030700,4124,3805,1843,1165,678,25755,36,013,030700
36013030800,3686,3475,1713,1078,635,31416,36,013,030800
36013035100,4088,3895,1719,1443,276,33510,36,013,035100
36013035300,2535,2434,1081,951,130,45234,36,013,035300
36013035400,2665,2010,1309,598,711,22182,36,013,035400
36013035500,2829,2127,1338,675,663,25605,36,013,035500
36013035600,3227,2555,1360,912,448,22358,36,013,035600
36013035700,3091,2442,1395,777,618,23938,36,013,035700
36013035800,3269,3074,1378,768,610,22941,36,013,035800
36013035901,5011,4235,2197,1528,669,44081,36,013,035901
36013035902,2221,1545,93,49,44,3939,36,013,035902
36013036000,4744,4281,1911,1484,427,31758,36,013,036000
36013036100,4554,4307,1937,1613,324,37861,36,013,036100
36013036300,4608,3970,1710,1220,490,25631,36,013,036300
36013036401,2653,2404,1055,819,236,24042,36,013,036401
36013036402,3770,3585,1460,1282,178,37344,36,013,036402
36013036500,4599,4256,2228,1591,637,31627,36,013,036500
36013036600,3140,3062,1258,1071,187,29073,36,013,036600
36013036700,4390,4256,1427,1191,236,32565,36,013,036700
36013036801,2443,2405,1000,874,126,36285,36,013,036801
36013036802,2070,2058,859,708,151,33646,36,013,036802
36047009202,3453,1023,1133,183,950,23039,36,047,009202
36047009401,2293,173,612,201,411,22411,36,047,009401
36047009402,2746,471,800,148,652,21995,36,047,009402
36047009600,5858,2122,1878,577,1301,24879,36,047,009600
36047009800,6021,923,1676,337,1339,22528,36,047,009800
36047010000,5978,1578,1734,462,1272,25176,36,047,010000
36047010100,3944,2011,1494,408,1086,46646,36,047,010100
36047010200,4844,599,1244,307,937,23442,36,047,010200
36047010401,2152,229,593,159,434,21497,36,047,010401
36047010402,2256,144,647,156,491,19621,36,047,010402
36047010601,2315,118,694,134,560,20601,36,047,010601
36047010602,1952,135,550,222,328,21705,36,047,010602
36047010801,1957,200,595,204,391,24797,36,047,010801
36047010802,2022,230,737,127,610,18021,36,047,010802
36047011000,2356,1212,631,293,338,27013,36,047,011000
36047011200,6088,3283,2106,310,1796,25785,36,047,011200
36047011400,3846,2167,906,197,709,25375,36,047,011400
36047011600,3510,343,1024,227,797,21541,36,047,011600
36047011700,2949,1404,1153,371,782,63088,36,047,011700
36047011800,1951,120,577,101,476,21672,36,047,011800
36047011901,1358,871,589,227,362,50455,36,047,011901
36047011902,0,0,0,0,0,-666666666,36,047,011902
36047012000,1327,73,352,170,182,20104,36,047,012000
36047012100,1968,1588,814,284,530,70926,36,047,012100
36047012200,5144,879,1563,283,1280,19408,36,047,012200
36047012600,2799,964,842,256,586,23611,36,047,012600
36047012700,4066,1523,1622,310,1312,59917,36,047,012700
36047012801,2279,718,798,253,545,26467,36,047,012801
36047012901,2246,1658,911,352,559,75657,36,047,012901
36047012902,2724,1616,1168,221,947,76250,36,047,012902
36047013000,4416,2660,1557,373,1184,44020,36,047,013000
36047013100,4267,2589,1976,755,1221,82445,36,047,013100
36047013200,2299,984,695,312,383,30606,36,047,013200
36047013300,4465,3428,1794,702,1092,100946,36,047,013300
36047013400,4163,2723,1385,540,845,43929,36,047,013400
36047013500,4240,3204,1497,823,674,93558,36,047,013500
36047013600,3829,2907,1403,659,744,60140,36,047,013600
36047013700,3484,2308,1526,408,1118,72054,36,047,013700
36047013800,3527,2580,1254,355,899,51714,36,047,013800
36047013900,3574,2498,1436,356,1080,76515,36,047,013900
36047014000,1944,1451,840,364,476,50000,36,047,014000
36047014101,968,660,425,171,254,66250,36,047,014101
36047014102,1863,1098,778,243,535,91382,36,047,014102
36047014200,2992,1737,1269,518,751,38553,36,047,014200
36047014300,3599,2052,1345,301,1044,54669,36,047,014300
36047014500,3909,2918,1748,331,1417,56505,36,047,014500
36051030600,4086,3932,1484,1149,335,31285,36,051,030600
36051030701,2309,2146,893,864,29,35218,36,051,030701
36051030702,5247,4971,2098,1720,378,40326,36,051,030702
36051030800,4761,4577,1803,1567,236,36488,36,051,030800
36051030900,3064,2614,1431,943,488,32762,36,051,030900
36051031000,1887,895,0,0,0,9219,36,051,031000
36051031101,2050,1932,846,790,56,32500,36,051,031101
36051031102,2319,2173,1048,957,91,39036,36,051,031102
36051031200,3919,3826,1667,1296,371,39625,36,051,031200
36051031300,4104,4028,1770,1593,177,34102,36,051,031300
36051031400,4653,4240,2271,1733,538,34279,36,051,031400
36053030101,2455,2252,1048,418,630,31959,36,053,030101
36053030102,5216,4967,2243,1367,876,33750,36,053,030102
36053030103,3247,3104,1260,1041,219,38550,36,053,030103
36053030200,3656,3328,1329,1053,276,30679,36,053,030200
36053030300,5197,4571,1901,1191,710,33601,36,053,030300
36053030401,4985,4878,1857,1268,589,44942,36,053,030401
36053030402,3037,2909,1153,1010,143,42412,36,053,030402
36053030403,4435,4044,1560,1444,116,33776,36,053,030403
36053030404,2697,2632,1041,994,47,39269,36,053,030404
36053030501,3345,3015,1047,750,297,12261,36,053,030501
36053030502,3653,3600,1476,1375,101,34821,36,053,030502
36053030601,3422,3186,1109,986,123,35454,36,053,030601
36053030602,3609,3513,1374,1254,120,37310,36,053,030602
36053030701,4788,4272,1369,1159,210,17003,36,053,030701
36053030702,1888,1807,771,666,105,40750,36,053,030702
36053030800,3716,3508,1344,1167,177,31948,36,053,030800
36053030900,3754,3015,873,498,375,5723,36,053,030900
36053031000,5636,5532,2347,2012,335,35308,36,053,031000
36053031100,2254,2228,857,712,145,32089,36,053,031100
36055000200,1496,596,761,55,706,18083,36,055,000200
36055000700,1862,596,669,261,408,18524,36,055,000700
36055001000,3683,2657,2423,230,2193,40492,36,055,001000
36055001300,1863,422,514,0,514,25132,36,055,001300
36055001600,2416,588,919,295,624,20250,36,055,001600
36055001800,4574,2244,2314,1142,1172,30030,36,055,001800
36055001900,2680,1153,1157,583,574,29419,36,055,001900
36055002000,5142,2514,2038,1019,1019,30457,36,055,002000
36055002100,4193,1277,1368,725,643,25402,36,055,002100
36055002200,3386,711,1059,297,762,22015,36,055,002200
36055002300,4002,1533,1710,257,1453,18203,36,055,002300
36055002400,3650,624,1259,308,951,24808,36,055,002400
36055002700,1392,50,606,224,382,24769,36,055,002700
36055002900,3863,3216,2163,284,1879,38781,36,055,002900
36055003000,2174,1573,1157,240,917,31406,36,055,003000
36055003101,2457,2196,1467,502,965,48789,36,055,003101
36013036901,2620,2539,1208,1028,180,40151,36,013,036901
36013036902,3225,3208,1435,1193,242,35488,36,013,036902
36013037000,3552,3465,1442,1290,152,46164,36,013,037000
36013037100,3642,3478,1744,1096,648,32837,36,013,037100
36013037200,3570,3435,1524,1089,435,37431,36,013,037200
36013037300,4750,4652,2069,1501,568,38472,36,013,037300
36013037400,3727,3612,1405,1205,200,33646,36,013,037400
36013037500,4750,4680,1998,1686,312,31239,36,013,037500
36013037600,2551,2473,1106,867,239,30843,36,013,037600
36013990000,0,0,0,0,0,-666666666,36,013,990000
36015000100,2644,2232,1222,767,455,27035,36,015,000100
36015000200,2488,2147,1001,636,365,25717,36,015,000200
36015000300,1780,775,0,0,0,-666666666,36,015,000300
36015000400,2452,1741,1019,553,466,34609,36,015,000400
36015000500,2601,2403,1156,613,543,27212,36,015,000500
36015000600,3514,2708,1148,331,817,7324,36,015,000600
36015000700,2175,1690,873,102,771,13875,36,015,000700
36015000900,3199,2708,1217,908,309,26959,36,015,000900
36015001000,2897,2369,1106,319,787,24254,36,015,001000
36015001100,3486,2616,1257,854,403,27370,36,015,001100
36015010100,3366,3277,1303,1180,123,36466,36,015,010100
36015010200,5799,5204,2339,2108,231,37986,36,015,010200
36015010301,4577,4309,1897,1559,338,38696,36,015,010301
36015010302,2982,2953,1236,909,327,46185,36,015,010302
36015010400,3541,3081,1733,1248,485,43698,36,015,010400
36015010500,2825,2344,1428,569,859,30319,36,015,010500
36015010600,2976,2543,1278,801,477,34181,36,015,010600
36015010701,3074,2511,1101,715,386,50893,36,015,010701
36015010702,4189,3905,1591,1253,338,41783,36,015,010702
36015010800,3772,3406,1766,860,906,29531,36,015,010800
36015010900,4781,4484,2065,1835,230,45720,36,015,010900
36015011000,3566,3542,1450,1266,184,34644,36,015,011000
36015011101,2440,2375,1311,872,439,29564,36,015,011101
36015011102,4381,3935,2178,1399,779,34019,36,015,011102
36015011200,4610,4246,1653,1412,241,32360,36,015,011200
36017970101,2915,2865,1223,981,242,27436,36,017,970101
36017970102,3196,3075,1215,903,312,24758,36,017,970102
36017970201,1969,1902,866,738,128,33750,36,017,970201
36017970202,2184,2135,921,758,163,28681,36,017,970202
36017970300,3781,3509,1845,857,988,28068,36,017,970300
36017970400,2848,2559,1374,421,953,22417,36,017,970400
36017970501,2214,2179,920,730,190,31512,36,017,970501
36017970502,3267,3127,1296,1154,142,36429,36,017,970502
36017970601,4128,3806,1679,1486,193,29882,36,017,970601
36017970602,3562,3460,1581,1258,323,38036,36,017,970602
36017970700,2335,2204,1130,923,207,35400,36,017,970700
36047014700,2646,1721,888,372,516,64435,36,047,014700
36047014800,1242,904,436,289,147,58929,36,047,014800
36047014901,1478,1348,574,250,324,83614,36,047,014901
36047014902,4569,3783,1853,560,1293,78764,36,047,014902
36047015000,1592,1180,613,337,276,42013,36,047,015000
36047015100,4170,3489,1734,872,862,76964,36,047,015100
36047015200,2650,1489,958,513,445,39826,36,047,015200
36047015300,2530,1961,1141,419,722,65417,36,047,015300
36047015400,10,0,10,10,0,-666666666,36,047,015400
36047015500,3927,2846,1574,890,684,82241,36,047,015500
36047015700,4332,3183,2078,888,1190,75649,36,047,015700
36047015900,4778,3648,2341,1122,1219,95296,36,047,015900
36047016000,4134,2548,1612,386,1226,41830,36,047,016000
36047016100,3552,2461,1491,671,820,79083,36,047,016100
36047016200,2169,1417,1144,383,761,54464,36,047,016200
36047016300,3489,2508,1545,420,1125,73618,36,047,016300
36047016400,1326,703,302,27,275,41528,36,047,016400
36047016500,5973,4712,2321,1525,796,107260,36,047,016500
36047016600,1852,1603,698,613,85,67375,36,047,016600
36047016700,4906,4045,2286,1065,1221,81512,36,047,016700
36047016800,1924,1298,767,522,245,64569,36,047,016800
36047016900,4817,3828,2058,471,1587,67333,36,047,016900
36047017000,2935,1476,1044,654,390,40981,36,047,017000
36047017100,4213,3521,1609,765,844,80809,36,047,017100
36047017200,3275,1403,1075,450,625,41136,36,047,017200
36047017400,2155,1212,736,515,221,61050,36,047,017400
36047017500,0,0,0,0,0,-666666666,36,047,017500
36047017600,2455,1455,874,483,391,46525,36,047,017600
36047017700,0,0,0,0,0,-666666666,36,047,017700
36047017800,3041,1319,896,309,587,39576,36,047,017800
36047017900,4385,1031,1566,544,1022,48103,36,047,017900
36047018000,3424,1597,1065,521,544,38269,36,047,018000
36047018100,3785,2520,1969,531,1438,72193,36,047,018100
36047018200,3421,1030,1109,522,587,26504,36,047,018200
36047018300,2663,1779,1162,393,769,72688,36,047,018300
36047018400,2318,1042,824,578,246,45128,36,047,018400
36047018501,4130,787,1838,187,1651,30099,36,047,018501
36047018600,2255,1170,745,380,365,31979,36,047,018600
36047018700,1459,788,516,146,370,60054,36,047,018700
36047018800,2905,1682,1110,473,637,38125,36,047,018800
36047019000,4543,1414,1511,515,996,27075,36,047,019000
36047019100,2964,1624,1142,332,810,60583,36,047,019100
36047019200,2716,1076,703,245,458,25813,36,047,019200
36047019300,6140,2528,2548,1347,1201,41283,36,047,019300
36047019400,3465,1017,1101,504,597,19353,36,047,019400
36047019500,3128,1728,1689,1033,656,63250,36,047,019500
36047019600,4238,1658,1413,511,902,30690,36,047,019600
36055003102,2059,1976,1336,182,1154,37913,36,055,003102
36055003200,1733,1020,1087,74,1013,25054,36,055,003200
36055003300,1593,1123,980,273,707,37672,36,055,003300
36055003400,2579,1802,1301,417,884,33393,36,055,003400
36055003500,1743,1574,507,348,159,42457,36,055,003500
36055003600,2660,2067,1389,696,693,44561,36,055,003600
36055003700,2972,2288,1418,386,1032,38029,36,055,003700
36055003806,4914,2441,1853,353,1500,14320,36,055,003806
36055003807,4066,3091,637,386,251,4852,36,055,003807
36055003900,1664,669,710,238,472,16184,36,055,003900
36055004000,1404,799,437,86,351,25029,36,055,004000
36055004100,1565,771,521,222,299,-666666666,36,055,004100
36055004602,1996,668,1180,75,1105,22000,36,055,004602
36055004701,2987,1616,1550,375,1175,33235,36,055,004701
36055004702,2525,998,965,484,481,29029,36,055,004702
36055004800,2340,541,681,212,469,26173,36,055,004800
36055004900,2267,592,659,121,538,20250,36,055,004900
36055005000,1941,529,665,174,491,18625,36,055,005000
36055005100,1303,401,543,88,455,18234,36,055,005100
36055005200,1422,407,462,148,314,33594,36,055,005200
36055005400,3667,943,1513,955,558,38630,36,055,005400
36055005500,1870,282,570,206,364,23973,36,055,005500
36055005600,2294,612,906,258,648,17652,36,055,005600
36055005700,1456,216,527,140,387,22609,36,055,005700
36055005800,3821,737,1449,479,970,21935,36,055,005800
36055005900,1413,268,481,158,323,19351,36,055,005900
36055006000,3194,1895,1548,906,642,34249,36,055,006000
36055006100,2218,1870,1146,897,249,42601,36,055,006100
36055006200,2448,776,1057,508,549,31949,36,055,006200
36055006300,3166,473,1095,561,534,28598,36,055,006300
36055006400,2255,45,943,411,532,27619,36,055,006400
36055006500,1502,176,585,82,503,16250,36,055,006500
36055006600,1963,387,850,184,666,24357,36,055,006600
36055006700,3057,817,1012,609,403,30576,36,055,006700
36055006800,2710,743,1209,566,643,37425,36,055,006800
36055006900,1912,319,855,123,732,23474,36,055,006900
36055007000,2980,1426,1132,570,562,24766,36,055,007000
36055007100,3263,773,1275,625,650,23609,36,055,007100
36055007500,2579,191,1042,310,732,22137,36,055,007500
36055007600,2796,2131,1416,1123,293,46570,36,055,007600
36055007700,2487,1808,1298,647,651,41883,36,055,007700
36055007801,2427,2165,1526,407,1119,45093,36,055,007801
36055007802,1491,1362,775,636,139,63040,36,055,007802
36055007900,1777,826,674,210,464,16792,36,055,007900
36055008000,1943,416,815,432,383,23469,36,055,008000
36055008100,4846,1878,1584,825,759,27225,36,055,008100
36055008200,3237,1146,1175,682,493,26580,36,055,008200
36017970801,3790,3589,1736,1406,330,38115,36,017,970801
36017970802,3374,3337,1432,1163,269,33989,36,017,970802
36017970901,2827,2769,1347,1211,136,41571,36,017,970901
36017970902,1943,1931,922,569,353,41273,36,017,970902
36017971000,3194,3015,1347,1016,331,37266,36,017,971000
36019100101,2677,2606,981,673,308,31259,36,019,100101
36019100102,2949,2860,1404,802,602,36335,36,019,100102
36019100200,4144,3876,1538,1191,347,38811,36,019,100200
36019100600,5469,5373,2078,1689,389,40085,36,019,100600
36019100700,3699,3544,1608,1211,397,37863,36,019,100700
36019100800,4652,4196,1759,1513,246,33778,36,019,100800
36019100901,3268,3172,1602,632,970,25231,36,019,100901
36019100902,1792,1733,1041,485,556,37656,36,019,100902
36019101000,3998,3732,1645,1032,613,43641,36,019,101000
36019101600,1515,1401,721,409,312,34861,36,019,101600
36019101901,5157,5049,2043,1543,500,44857,36,019,101901
36019101902,937,840,390,337,53,37813,36,019,101902
36019102100,2001,1916,748,516,232,33554,36,019,102100
36019102200,3084,2681,1291,517,774,33938,36,019,102200
36019102800,3243,3039,1345,1011,334,41040,36,019,102800
36019103000,2595,1551,0,0,0,3165,36,019,103000
36019103100,2595,2185,1300,183,1117,20334,36,019,103100
36019103200,2011,1882,1124,379,745,36731,36,019,103200
36019103512,7320,4684,1712,1289,423,36297,36,019,103512
36019103800,5838,5735,2421,2000,421,39217,36,019,103800
36019103900,5144,4902,2198,1801,397,38579,36,019,103900
36019104200,6232,5678,2608,2208,400,37071,36,019,104200
36021000100,2256,2222,958,747,211,36907,36,021,000100
36021000200,1724,1543,779,673,106,40990,36,021,000200
36021000300,3871,3381,1580,1268,312,40526,36,021,000300
36021000401,2467,2425,1105,897,208,41250,36,021,000401
36021000402,5796,5320,2200,1664,536,48644,36,021,000402
36021000500,2281,2172,921,693,228,42470,36,021,000500
36021000600,2656,2430,1031,823,208,34121,36,021,000600
36021000700,5120,4621,1914,1437,477,32515,36,021,000700
36021000800,1636,1587,778,665,113,31469,36,021,000800
36021000900,1465,1328,688,538,150,37282,36,021,000900
36021001000,5684,5198,2549,2040,509,39273,36,021,001000
36021001100,4264,3391,1991,1162,829,38750,36,021,001100
36021001200,3048,1783,1342,535,807,30223,36,021,001200
36021001300,3055,2191,1264,368,896,22264,36,021,001300
36021001400,3476,2949,1546,1075,471,31735,36,021,001400
36021001500,1182,1105,511,459,52,45208,36,021,001500
36021001600,3426,3136,1386,1144,242,42769,36,021,001600
36021001700,1309,1200,554,455,99,32240,36,021,001700
36021001800,1473,1347,620,547,73,40547,36,021,001800
36047019700,3669,2128,1758,962,796,87250,36,047,019700
36047019800,1877,907,626,351,275,32436,36,047,019800
36047019900,3769,2287,1771,410,1361,72764,36,047,019900
36047020000,2296,1085,690,373,317,34361,36,047,020000
36047020100,3940,2307,1884,636,1248,64643,36,047,020100
36047020200,1963,1000,614,385,229,45189,36,047,020200
36047020300,1773,858,693,226,467,80929,36,047,020300
36047020400,1710,1236,672,538,134,55753,36,047,020400
36047020500,3164,1885,1438,528,910,75043,36,047,020500
36047020600,2355,1576,824,534,290,56667,36,047,020600
36047020700,4490,2990,2292,1011,1281,82283,36,047,020700
36047020800,3159,926,1041,434,607,24019,36,047,020800
36047021000,3935,1191,1319,460,859,22500,36,047,021000
36047021100,2795,839,1220,288,932,44349,36,047,021100
36047021200,4123,917,1354,392,962,21161,36,047,021200
36047021300,4166,965,1910,56,1854,41474,36,047,021300
36047021400,2128,1083,514,189,325,27500,36,047,021400
36047021500,6013,3304,2608,836,1772,71405,36,047,021500
36047021600,3790,2983,848,187,661,23450,36,047,021600
36047021700,3407,1214,1725,315,1410,58875,36,047,021700
36047021800,2891,2373,812,296,516,27076,36,047,021800
36047021900,3677,1160,1611,307,1304,61819,36,047,021900
36047022000,4894,4131,1333,278,1055,22129,36,047,022000
36047022100,3813,1482,1544,371,1173,45598,36,047,022100
36047022200,3991,3720,1019,223,796,18209,36,047,022200
36047022400,5393,4810,1310,409,901,22902,36,047,022400
36047022600,2167,1443,543,187,356,27438,36,047,022600
36047022700,3873,1703,1702,491,1211,65267,36,047,022700
36047022800,3938,2556,859,314,545,17782,36,047,022800
36047022900,3832,1911,1744,465,1279,59432,36,047,022900
36047023000,4619,3921,932,286,646,20750,36,047,023000
36047023100,3652,1875,1645,554,1091,57048,36,047,023100
36047023200,5865,5400,1152,302,850,20223,36,047,023200
36047023300,6023,2832,2119,489,1630,40605,36,047,023300
36047023400,4833,4721,1242,110,1132,20016,36,047,023400
36047023500,5036,3881,1431,300,1131,35246,36,047,023500
36047023600,5352,5145,1374,91,1283,21141,36,047,023600
36047023800,3817,3756,1066,303,763,30338,36,047,023800
36047024000,5167,4710,1387,306,1081,22045,36,047,024000
36047024100,2955,2017,1077,176,901,42639,36,047,024100
36047024200,2826,2491,722,345,377,28625,36,047,024200
36047024300,4214,1394,1883,648,1235,45787,36,047,024300
36047024400,3547,2583,943,370,573,21579,36,047,024400
36047024500,4688,1262,1895,484,1411,54397,36,047,024500
36047024600,2868,1620,887,433,454,35821,36,047,024600
36047024700,2697,682,1215,105,1110,46002,36,047,024700
36047024800,2548,1200,770,324,446,35595,36,047,024800
36055008301,4710,1990,1861,1023,838,23416,36,055,008301
36055008400,3056,1046,1065,460,605,23063,36,055,008400
36055008500,3369,2416,2041,828,1213,30500,36,055,008500
36055008600,4151,3163,2038,1320,718,37090,36,055,008600
36055008702,1374,400,587,185,402,26378,36,055,008702
36055008801,6006,2703,2248,1095,1153,25613,36,055,008801
36055009200,1100,400,565,59,506,20292,36,055,009200
36055009301,2245,702,893,120,773,19915,36,055,009301
36055009302,1827,1390,1154,97,1057,26908,36,055,009302
36055009401,2138,1490,1217,70,1147,31551,36,055,009401
36055009402,1637,1190,1102,233,869,67749,36,055,009402
36055009403,975,340,0,0,0,5045,36,055,009403
36055009404,316,248,140,0,140,43556,36,055,009404
36055009500,3231,1823,1699,488,1211,41338,36,055,009500
36055009601,1416,555,716,148,568,21071,36,055,009601
36055009602,1654,251,518,164,354,20690,36,055,009602
36055009605,3456,1363,1084,255,829,15262,36,055,009605
36055010100,3414,2987,1549,1271,278,37554,36,055,010100
36055010200,3953,3811,1527,1511,16,44614,36,055,010200
36055010300,3867,3510,1571,1507,64,50254,36,055,010300
36055010400,4875,3775,2299,1636,663,38281,36,055,010400
36055010500,4421,4331,1747,1731,16,55769,36,055,010500
36055010601,2768,2335,1472,1056,416,32531,36,055,010601
36055010602,3732,2883,1725,1241,484,36382,36,055,010602
36055010700,3476,2770,1500,1145,355,36326,36,055,010700
36055010800,3103,2893,1354,1292,62,41240,36,055,010800
36055010901,4297,2721,1685,708,977,33856,36,055,010901
36055010902,3371,2335,1641,852,789,33365,36,055,010902
36055011000,4563,3811,2035,1691,344,47495,36,055,011000
36055011100,4583,3411,2124,1750,374,41882,36,055,011100
36055011201,3547,2990,1497,1343,154,42286,36,055,011201
36055011203,1961,1893,883,820,63,53354,36,055,011203
36055011205,5313,4792,2086,1791,295,52096,36,055,011205
36055011207,4781,4334,2117,1268,849,33000,36,055,011207
36055011209,4684,4192,2642,1089,1553,39798,36,055,011209
36055011210,810,767,434,299,135,38068,36,055,011210
36055011302,6030,5497,2194,2050,144,55669,36,055,011302
36055011303,2902,2764,1110,993,117,57672,36,055,011303
36055011304,4440,4213,1650,1650,0,60365,36,055,011304
36055011401,3322,3009,1229,797,432,40068,36,055,011401
36055011402,3960,3770,1652,1568,84,42036,36,055,011402
36055011403,3126,2523,1758,163,1595,35914,36,055,011403
36055011503,5346,4986,2021,1997,24,50781,36,055,011503
36055011504,7237,6725,2493,2478,15,52780,36,055,011504
36055011505,5559,5035,2150,1682,468,48567,36,055,011505
36055011506,3655,3197,1335,1270,65,67097,36,055,011506
36021001900,2034,1944,722,601,121,31660,36,021,001900
36021002000,1793,1678,884,739,145,40033,36,021,002000
36023970100,3472,3387,1311,1041,270,36337,36,023,970100
36023970201,2192,2124,935,857,78,42173,36,023,970201
36023970202,3189,3111,1292,916,376,34497,36,023,970202
36023970300,3003,2871,1380,1045,335,40142,36,023,970300
36023970400,2695,2508,1031,785,246,36342,36,023,970400
36023970500,4120,3836,1621,663,958,26366,36,023,970500
36023970600,2972,2823,1329,365,964,24529,36,023,970600
36023970700,4161,3865,1714,1312,402,31815,36,023,970700
36023970800,2485,2100,62,22,40,4273,36,023,970800
36023970900,4895,4466,1930,765,1165,22879,36,023,970900
36023971000,5443,5067,2034,1390,644,34286,36,023,971000
36023971100,4711,4512,1778,1398,380,30743,36,023,971100
36023971200,4280,4045,1563,1347,216,36804,36,023,971200
36025970101,1498,1396,638,500,138,25714,36,025,970101
36025970102,2741,2599,1209,913,296,33259,36,025,970102
36025970200,3410,3221,1398,1151,247,30861,36,025,970200
36025970300,2460,2414,1119,961,158,29177,36,025,970300
36025970401,1723,1667,701,669,32,40543,36,025,970401
36025970402,3668,3264,1417,813,604,26453,36,025,970402
36025970501,2263,2104,1003,780,223,36241,36,025,970501
36025970502,1664,1645,695,610,85,30909,36,025,970502
36025970601,2107,1992,1013,496,517,16543,36,025,970601
36025970602,3028,2969,1273,948,325,32028,36,025,970602
36025970700,2236,2154,1012,814,198,33833,36,025,970700
36025970800,3276,3075,1434,934,500,26821,36,025,970800
36025970900,1502,1112,0,0,0,4090,36,025,970900
36025971000,2704,2579,1171,843,328,29477,36,025,971000
36025971100,2020,1963,1000,875,125,40500,36,025,971100
36025971200,3459,3024,1701,1300,401,31042,36,025,971200
36025971300,1894,1775,684,607,77,33259,36,025,971300
36025971400,3023,2921,1462,1082,380,28025,36,025,971400
36027010000,4324,3689,1552,951,601,38077,36,027,010000
36027020003,4729,3851,1543,1339,204,41895,36,027,020003
36027020004,2724,2313,896,843,53,52111,36,027,020004
36027020005,4804,4408,1727,1455,272,49859,36,027,020005
36027030000,4220,3989,1653,1505,148,37448,36,027,030000
36027040001,4656,4312,1979,1402,577,34280,36,027,040001
36027040003,3714,3177,1468,1000,468,43359,36,027,040003
36027050102,3735,3033,1320,1126,194,46268,36,027,050102
36027050103,5817,5432,1865,1827,38,51857,36,027,050103
36027050104,6426,4707,2073,1908,165,50920,36,027,050104
36027050203,4982,4056,1695,1516,179,43546,36,027,050203
36027050204,2966,2615,926,889,37,60694,36,027,050204
36047024900,4147,1726,1889,377,1512,47716,36,047,024900
36047025000,1799,191,538,272,266,24844,36,047,025000
36047025100,3716,1203,1653,301,1352,35988,36,047,025100
36047025200,5257,1956,1915,587,1328,22248,36,047,025200
36047025300,3616,1698,1324,360,964,42717,36,047,025300
36047025400,3178,1146,1074,490,584,21533,36,047,025400
36047025500,5203,856,2208,91,2117,17815,36,047,025500
36047025600,3166,865,925,429,496,23750,36,047,025600
36047025700,2541,1129,748,156,592,35417,36,047,025700
36047025800,4467,1831,1529,333,1196,24862,36,047,025800
36047025901,1874,775,716,56,660,34548,36,047,025901
36047025902,3650,336,1357,44,1313,14877,36,047,025902
36047026000,3184,1478,1089,532,557,30531,36,047,026000
36047026100,4798,1180,2161,65,2096,49226,36,047,026100
36047026200,2513,788,783,349,434,27191,36,047,026200
36047026300,2047,417,957,225,732,39107,36,047,026300
36047026400,4491,1517,1477,304,1173,27237,36,047,026400
36047026500,4032,1163,1782,507,1275,52949,36,047,026500
36047026600,3592,929,1118,464,654,25982,36,047,026600
36047026700,4277,1402,1918,676,1242,48932,36,047,026700
36047026800,4299,2076,1523,573,950,29635,36,047,026800
36047026900,3365,709,1261,418,843,48356,36,047,026900
36047027000,2147,1498,832,241,591,24054,36,047,027000
36047027100,3351,712,1268,201,1067,47141,36,047,027100
36047027200,3725,2025,1319,516,803,34364,36,047,027200
36047027300,3651,621,1385,517,868,44531,36,047,027300
36047027400,3377,1365,995,455,540,30101,36,047,027400
36047027500,4711,944,1802,575,1227,48125,36,047,027500
36047027600,3638,1195,1208,174,1034,27661,36,047,027600
36047027700,4449,637,1682,426,1256,44322,36,047,027700
36047027800,3141,1277,1162,380,782,37049,36,047,027800
36047027900,3548,820,1629,459,1170,45966,36,047,027900
36047028000,1869,718,653,360,293,39337,36,047,028000
36047028100,4738,809,1807,143,1664,31676,36,047,028100
36047028200,3605,1675,1358,614,744,37090,36,047,028200
36047028300,3701,1015,1455,239,1216,25328,36,047,028300
36047028400,3440,1811,1397,182,1215,29008,36,047,028400
36047028501,386,174,152,0,152,31750,36,047,028501
36047028502,2937,142,1132,0,1132,24629,36,047,028502
36047028600,5257,2664,1848,172,1676,27054,36,047,028600
36047028700,3308,893,1332,267,1065,50020,36,047,028700
36047028800,3422,1337,981,334,647,30222,36,047,028800
36047028900,3728,734,1487,366,1121,37152,36,047,028900
36047029000,3539,2337,1569,191,1378,31545,36,047,029000
36047029100,3232,843,1301,258,1043,39878,36,047,029100
36047029200,2776,1298,1015,206,809,34076,36,047,029200
36047029300,3353,453,1351,284,1067,31816,36,047,029300
36027050205,5467,4665,1851,1655,196,48852,36,027,050205
36027060100,5582,3175,2007,980,1027,42708,36,027,060100
36027060201,3645,2812,1571,1119,452,52306,36,027,060201
36027060202,4362,3730,1971,1322,649,42049,36,027,060202
36027060301,3987,3783,1466,1227,239,52105,36,027,060301
36027060302,2445,1859,1036,835,201,54828,36,027,060302
36027060400,1967,1703,1026,310,716,49744,36,027,060400
36027070101,4227,3697,1695,1251,444,49350,36,027,070101
36027070102,3798,3013,1282,1010,272,36693,36,027,070102
36027070201,2733,2342,1342,793,549,43208,36,027,070201
36027070301,5644,4274,2368,1737,631,44406,36,027,070301
36027070401,4481,3346,1055,909,146,15232,36,027,070401
36027080103,4623,4046,1483,1323,160,57089,36,027,080103
36027080104,4205,3430,1405,1171,234,50833,36,027,080104
36027080201,3849,3202,1528,1440,88,49761,36,027,080201
36027080202,2897,2318,1002,856,146,40737,36,027,080202
36027090000,2418,2115,1046,812,234,50346,36,027,090000
36027100000,2941,2580,1276,911,365,42447,36,027,100000
36027110003,4150,3841,1458,1328,130,53279,36,027,110003
36027110004,1963,1618,778,543,235,35223,36,027,110004
36027110005,2105,1802,895,545,350,50086,36,027,110005
36027120000,2337,2206,951,688,263,30750,36,027,120000
36027130003,5426,4331,2271,1092,1179,44675,36,027,130003
36027130004,1573,1453,592,524,68,54091,36,027,130004
36027130005,2672,2569,1095,892,203,47964,36,027,130005
36027140101,6367,4346,1385,879,506,11520,36,027,140101
36027140201,2163,1749,1068,728,340,43738,36,027,140201
36027140202,4511,3852,1909,1158,751,45890,36,027,140202
36027140301,3078,2061,1706,609,1097,27772,36,027,140301
36027140302,2661,1535,1040,436,604,54750,36,027,140302
36027140400,5309,4221,1926,1736,190,57604,36,027,140400
36027140500,2774,1742,1280,609,671,41615,36,027,140500
36027140602,2728,2130,1043,813,230,43182,36,027,140602
36027140700,6652,5169,2413,2069,344,45745,36,027,140700
36027140801,2616,2207,1078,992,86,51866,36,027,140801
36027150003,2977,2453,677,345,332,6791,36,027,150003
36027150004,3338,3073,1202,970,232,41481,36,027,150004
36027150005,2694,2369,969,803,166,44654,36,027,150005
36027150006,2134,2003,965,566,399,41848,36,027,150006
36027160003,2634,2438,1024,743,281,52543,36,027,160003
36027160004,2587,2420,1092,846,246,66641,36,027,160004
36027160005,2565,2201,1283,597,686,40612,36,027,160005
36027170000,3738,3147,1480,1195,285,45650,36,027,170000
36027180001,4592,3866,1602,1288,314,46798,36,027,180001
36027190101,3202,2737,1197,1192,5,58347,36,027,190101
36047029400,2494,1296,613,86,527,38575,36,047,029400
36047029500,4212,931,1802,452,1350,43767,36,047,029500
36047029600,5246,3215,2093,533,1560,25545,36,047,029600
36047029700,4412,777,1800,788,1012,50083,36,047,029700
36047029800,3734,1223,1273,646,627,21178,36,047,029800
36047029900,2297,307,871,249,622,35844,36,047,029900
36047030000,3997,1217,1338,465,873,34808,36,047,030000
36047030100,3021,501,1137,361,776,50500,36,047,030100
36047030200,4419,1485,1405,648,757,41726,36,047,030200
36047030300,4864,366,2166,340,1826,43703,36,047,030300
36047030400,4358,1515,1727,402,1325,33511,36,047,030400
36047030500,6806,3442,2980,242,2738,55324,36,047,030500
36047030600,1852,995,637,379,258,27455,36,047,030600
36047030700,7084,854,3041,504,2537,27167,36,047,030700
36047030800,2035,1391,803,570,233,55034,36,047,030800
36047030900,2302,134,812,208,604,35770,36,047,030900
36047031100,2991,541,1267,167,1100,40051,36,047,031100
36047031300,4943,916,2240,421,1819,58345,36,047,031300
36047031401,4972,3190,1832,1005,827,40329,36,047,031401
36047031402,0,0,0,0,0,-666666666,36,047,031402
36047031500,5140,2233,2503,293,2210,47718,36,047,031500
36047031701,3671,1181,1467,310,1157,53790,36,047,031701
36047031702,3744,1290,1585,408,1177,53311,36,047,031702
36047031900,2847,1376,1241,276,965,53044,36,047,031900
36047032100,5396,1226,2286,186,2100,39888,36,047,032100
36047032300,3542,941,1482,268,1214,49856,36,047,032300
36047032500,5888,629,2595,88,2507,36611,36,047,032500
36047032600,6794,1337,2366,437,1929,31651,36,047,032600
36047032700,2696,634,1289,296,993,43646,36,047,032700
36047032800,2586,438,1137,456,681,35864,36,047,032800
36047032900,6083,2882,2204,370,1834,26521,36,047,032900
36047033000,4821,1243,1876,223,1653,23500,36,047,033000
36047033100,4168,2296,1559,399,1160,32143,36,047,033100
36047033300,4579,3230,1343,351,992,31391,36,047,033300
36047033500,3094,1838,871,336,535,32500,36,047,033500
36047033600,4701,3896,1598,766,832,40313,36,047,033600
36047033701,2211,859,824,212,612,34712,36,047,033701
36047033702,1669,1166,542,142,400,44787,36,047,033702
36047033900,4398,722,1995,552,1443,53763,36,047,033900
36047034000,1991,855,628,6,622,23654,36,047,034000
36047034100,3194,662,1294,196,1098,43186,36,047,034100
36047034200,6151,2040,2786,167,2619,33228,36,047,034200
36047034300,4942,625,2011,252,1759,30335,36,047,034300
36047034500,2924,851,1187,339,848,26660,36,047,034500
36047034700,3496,311,1810,350,1460,31060,36,047,034700
36047034800,3055,663,897,114,783,33083,36,047,034800
36047034901,2023,216,743,20,723,23275,36,047,034901
36003940200,3,2,1,1,0,-666666666,36,003,940200
36003950100,2444,2409,1044,936,108,36393,36,003,950100
36003950300,5105,4831,1542,1204,338,24647,36,003,950300
36003950401,1488,1407,611,520,91,29758,36,003,950401
36003950402,2078,2046,769,658,111,37887,36,003,950402
36027190102,2116,1612,794,364,430,46944,36,027,190102
36027190203,2493,1953,940,725,215,34387,36,027,190203
36027190204,5101,4116,1720,1664,56,52143,36,027,190204
36027190301,3777,2843,1666,582,1084,46344,36,027,190301
36027190401,2289,1627,819,564,255,39958,36,027,190401
36027190402,3065,2648,1318,996,322,42983,36,027,190402
36027200001,3259,2842,1430,1124,306,47212,36,027,200001
36027200002,1342,1195,752,338,414,41250,36,027,200002
36027210101,5520,3758,2125,1069,1056,37235,36,027,210101
36027210201,3887,2285,1634,963,671,45612,36,027,210201
36027210301,4284,3152,1603,1249,354,44496,36,027,210301
36027220101,3813,2445,1674,291,1383,32324,36,027,220101
36027220102,906,416,353,0,353,4528,36,027,220102
36027220201,3862,1318,1188,239,949,20109,36,027,220201
36027220300,4586,1047,1875,335,1540,30285,36,027,220300
36027220700,2661,880,1095,317,778,37258,36,027,220700
36027220801,3308,2391,1792,701,1091,45859,36,027,220801
36027220901,4048,2072,1710,843,867,31525,36,027,220901
36027221001,3846,3112,1701,1583,118,51544,36,027,221001
36027221100,3311,1070,1451,302,1149,23910,36,027,221100
36027300000,5639,3808,2155,699,1456,27926,36,027,300000
36027410000,4192,2792,776,524,252,6803,36,027,410000
36027610000,2162,448,38,0,38,10887,36,027,610000
36027640001,1424,342,0,0,0,14345,36,027,640001
36027640002,719,160,0,0,0,10727,36,027,640002
36029000110,2446,1802,980,515,465,27198,36,029,000110
36029000200,3985,3283,1616,701,915,27857,36,029,000200
36029000500,1646,1425,881,505,376,24279,36,029,000500
36029000600,4212,3835,1833,1398,435,38427,36,029,000600
36029000700,3498,3381,1553,1209,344,45839,36,029,000700
36029000800,4660,4047,1786,1192,594,43180,36,029,000800
36029000900,2438,2107,1060,612,448,37121,36,029,000900
36029001000,6026,5014,2520,1299,1221,30890,36,029,001000
36029001100,2775,2317,1547,780,767,35849,36,029,001100
36029001403,2090,69,1158,151,1007,19273,36,029,001403
36029001404,738,167,473,57,416,16410,36,029,001404
36029001500,1511,101,603,343,260,36055,36,029,001500
36029001601,1530,335,565,193,372,20522,36,029,001601
36029001602,1165,303,594,184,410,14390,36,029,001602
36029001700,1948,1348,848,430,418,20792,36,029,001700
36029001900,3295,2733,1405,763,642,27679,36,029,001900
36029002300,3451,2424,1401,683,718,25409,36,029,002300
36029002400,3285,2328,1609,873,736,27037,36,029,002400
36029002502,1816,230,1081,382,699,42785,36,029,002502
36029002703,1149,102,489,148,341,12399,36,029,002703
36029002704,2111,453,579,233,346,12289,36,029,002704
36047034902,4320,763,1614,178,1436,33202,36,047,034902
36047035000,2971,2948,1560,538,1022,36884,36,047,035000
36047035101,2330,183,901,118,783,27465,36,047,035101
36047035102,2320,810,864,168,696,35497,36,047,035102
36047035200,1162,757,504,0,504,49188,36,047,035200
36047035301,2559,616,1093,18,1075,30533,36,047,035301
36047035302,2725,598,919,134,785,34309,36,047,035302
36047035400,5720,5562,2756,1458,1298,43924,36,047,035400
36047035500,5499,1133,2077,84,1993,29076,36,047,035500
36047035601,2553,2305,1440,390,1050,32222,36,047,035601
36047035602,5586,5022,2763,1271,1492,36833,36,047,035602
36047035701,2317,145,1015,35,980,37165,36,047,035701
36047035702,0,0,0,0,0,-666666666,36,047,035702
36047035900,5718,330,2434,279,2155,36578,36,047,035900
36047036001,3156,2697,1669,400,1269,30678,36,047,036001
36047036002,3878,3370,2046,136,1910,30270,36,047,036002
36047036100,2834,300,1161,172,989,27122,36,047,036100
36047036200,3678,1805,1320,375,945,30014,36,047,036200
36047036300,5109,305,1940,265,1675,36393,36,047,036300
36047036400,2325,1415,933,303,630,32727,36,047,036400
36047036501,3564,20,1279,113,1166,42875,36,047,036501
36047036502,1562,167,503,109,394,37401,36,047,036502
36047036600,4129,1683,1283,300,983,30408,36,047,036600
36047036700,1211,234,504,148,356,32068,36,047,036700
36047036900,6056,938,2477,308,2169,28777,36,047,036900
36047037000,4016,2619,1446,947,499,41445,36,047,037000
36047037100,4689,648,1636,492,1144,45710,36,047,037100
36047037300,4358,897,1843,334,1509,37530,36,047,037300
36047037401,4679,3186,1858,679,1179,45785,36,047,037401
36047037402,4661,2379,2027,398,1629,41159,36,047,037402
36047037500,3232,643,1393,272,1121,40872,36,047,037500
36047037700,4575,659,1858,654,1204,50948,36,047,037700
36047037900,4671,408,1614,556,1058,37603,36,047,037900
36047038100,5351,892,2379,438,1941,42296,36,047,038100
36047038200,5714,570,2134,57,2077,15368,36,047,038200
36047038300,4737,892,1937,843,1094,49074,36,047,038300
36047038500,4324,557,1525,423,1102,47329,36,047,038500
36047038600,3448,1603,1056,522,534,33693,36,047,038600
36047038700,3965,1071,1453,501,952,44087,36,047,038700
36047038800,4419,3292,1705,477,1228,43899,36,047,038800
36047038900,3007,1641,1192,340,852,36761,36,047,038900
36047039000,2486,2184,777,501,276,43816,36,047,039000
36047039100,3536,1372,1456,127,1329,51436,36,047,039100
36047039200,3108,2666,1155,340,815,34412,36,047,039200
36047039300,4012,1692,1487,405,1082,43807,36,047,039300
36047039400,2240,1845,706,389,317,33393,36,047,039400
36005019900,7937,1226,3145,117,3028,30669,36,005,019900
36005020000,4750,830,1466,256,1210,24893,36,005,020000
36005020100,3887,482,1288,0,1288,26886,36,005,020100
36005020200,2387,335,875,135,740,30271,36,005,020200
36005020400,3279,711,994,194,800,41393,36,005,020400
36005020501,6910,1344,2697,40,2657,23368,36,005,020501
36005020502,2285,147,995,166,829,26581,36,005,020502
36005020601,2469,418,864,218,646,37898,36,005,020601
36005020900,4466,646,1848,0,1848,34523,36,005,020900
36005021001,8489,596,3666,751,2915,37490,36,005,021001
36005021002,7958,808,3263,559,2704,42183,36,005,021002
36005021100,5642,818,1803,111,1692,20116,36,005,021100
36005021200,4931,910,2323,582,1741,37066,36,005,021200
36005021301,1175,140,409,101,308,26844,36,005,021301
36005021302,5369,599,2406,52,2354,19412,36,005,021302
36005021501,4478,517,1319,26,1293,30655,36,005,021501
36005021502,6397,639,2112,106,2006,22617,36,005,021502
36005021601,4436,853,1468,263,1205,26460,36,005,021601
36005021602,5880,988,2200,527,1673,30296,36,005,021602
36005021700,5233,402,1610,7,1603,22666,36,005,021700
36005021800,6010,882,2265,408,1857,29721,36,005,021800
36005021900,857,89,379,0,379,22300,36,005,021900
36005022000,1985,271,620,14,606,25538,36,005,022000
36005022101,3908,480,1258,0,1258,23702,36,005,022101
36005022102,5433,724,1593,11,1582,19963,36,005,022102
36005022200,3064,449,1007,197,810,32964,36,005,022200
36005022300,5168,1105,1993,0,1993,18672,36,005,022300
36005022401,2470,437,1047,101,946,40709,36,005,022401
36005022403,2920,686,1230,163,1067,36875,36,005,022403
36005022404,4384,1025,1839,461,1378,39754,36,005,022404
36005022500,8937,1317,2220,79,2141,23640,36,005,022500
36005022701,4748,336,1934,44,1890,25776,36,005,022701
36005022702,1494,258,538,26,512,20591,36,005,022702
36005022703,1858,719,659,12,647,40398,36,005,022703
36005022800,6238,1768,2457,383,2074,46725,36,005,022800
36005022901,5196,705,1927,74,1853,25964,36,005,022901
36005022902,3416,739,1110,234,876,32448,36,005,022902
36005019700,7126,1275,2415,12,2403,22240,36,005,019700
36005023000,2821,757,1020,176,844,30776,36,005,023000
36005023100,1569,318,427,16,411,23911,36,005,023100
36005023200,2382,898,777,324,453,25592,36,005,023200
36005023301,3855,216,1601,154,1447,21988,36,005,023301
36005023302,3581,755,913,0,913,23696,36,005,023302
36005023501,3222,302,1187,0,1187,23908,36,005,023501
36005023502,4346,983,1486,75,1411,25132,36,005,023502
36005023600,1609,492,542,114,428,35139,36,005,023600
36029011300,4210,4002,2221,1877,344,34318,36,029,011300
36029011400,2361,2219,1129,623,506,26990,36,029,011400
36029011500,1399,1344,665,506,159,33478,36,029,011500
36029011600,2000,1591,967,574,393,41038,36,029,011600
36029011700,4072,3918,1874,1234,640,38042,36,029,011700
36029011800,3732,3615,1596,1188,408,50511,36,029,011800
36029012001,4657,4485,1895,1669,226,48370,36,029,012001
36029012002,3666,3603,1513,1126,387,43521,36,029,012002
36029012003,4978,4904,2105,1933,172,47813,36,029,012003
36029012300,3374,2762,1456,668,788,25950,36,029,012300
36029012400,1737,1355,837,521,316,30102,36,029,012400
36029012501,4139,3977,1931,986,945,24120,36,029,012501
36029012502,1871,1654,813,583,230,40173,36,029,012502
36029012800,2659,2594,1301,732,569,35344,36,029,012800
36029012902,3933,3810,1885,1050,835,37627,36,029,012902
36029012903,2821,2565,1395,813,582,44681,36,029,012903
36029012904,3917,3704,1871,1122,749,41417,36,029,012904
36029013001,2653,2420,1474,961,513,31625,36,029,013001
36029013002,5812,5604,2526,2053,473,40053,36,029,013002
36029013101,6514,6245,2917,2236,681,45036,36,029,013101
36029013103,4225,4175,1451,1440,11,52836,36,029,013103
36029013104,4574,4246,1753,1688,65,41542,36,029,013104
36029013201,5995,5792,2521,1852,669,43633,36,029,013201
36029013202,5305,5231,2152,1602,550,39885,36,029,013202
36029013300,3548,3471,1569,1234,335,44898,36,029,013300
36029013400,6508,6321,2796,2116,680,51303,36,029,013400
36029013501,6941,6608,2849,1945,904,46324,36,029,013501
36029013502,7144,6483,2658,2591,67,71369,36,029,013502
36029013600,2943,2840,1296,812,484,47844,36,029,013600
36029013701,6607,6275,2943,1952,991,35208,36,029,013701
36029013702,5942,5807,2507,1664,843,52679,36,029,013702
36029013801,2187,2187,889,683,206,41750,36,029,013801
36029013802,5454,5411,2197,1869,328,48329,36,029,013802
36029013900,2341,2278,973,814,159,51179,36,029,013900
36029014000,3788,3648,1449,1072,377,47685,36,029,014000
36029014101,6302,6190,2598,2101,497,46625,36,029,014101
36029014102,5454,5369,2200,1597,603,43491,36,029,014102
36029014204,3884,3829,1873,1340,533,54207,36,029,014204
36029014206,7580,6979,2669,2637,32,60101,36,029,014206
36029014207,5281,5063,2253,1469,784,41328,36,029,014207
36029014208,5915,5579,2474,2172,302,55794,36,029,014208
36029014209,4546,4379,1826,1554,272,50153,36,029,014209
36029014300,5936,5766,2804,2177,627,35531,36,029,014300
36029014400,4151,4063,2209,1408,801,37043,36,029,014400
36029014501,3722,3561,1706,1453,253,42911,36,029,014501
36029014502,2193,1912,1060,467,593,35491,36,029,014502
36047054600,4798,3388,1855,328,1527,38471,36,047,054600
36047054700,5970,4495,1828,321,1507,40380,36,047,054700
36047054800,2134,1988,751,312,439,64375,36,047,054800
36047054900,4434,3668,1713,220,1493,72961,36,047,054900
36047055000,3223,2499,1352,379,973,42222,36,047,055000
36047055100,5033,2790,2269,421,1848,57197,36,047,055100
36047055200,3393,2554,1455,434,1021,49688,36,047,055200
36047055300,2942,1925,1361,347,1014,61629,36,047,055300
36047055400,4064,3189,1632,210,1422,39050,36,047,055400
36047055500,8541,5832,4139,1133,3006,91151,36,047,055500
36047055600,3657,3075,1278,484,794,34578,36,047,055600
36047055700,1633,1258,895,101,794,71679,36,047,055700
36047055800,2496,1797,960,337,623,45938,36,047,055800
36047056000,3390,2804,1413,595,818,47333,36,047,056000
36047056100,3561,2725,1642,284,1358,64056,36,047,056100
36047056200,1747,1592,534,475,59,64125,36,047,056200
36047056301,4024,3191,1754,231,1523,60156,36,047,056301
36047056302,1513,694,716,0,716,38377,36,047,056302
36047056400,2491,1621,959,778,181,52449,36,047,056400
36047056500,3177,2698,1751,242,1509,74113,36,047,056500
36047056600,2748,1481,1014,414,600,46023,36,047,056600
36047056800,1449,831,542,387,155,43500,36,047,056800
36047056900,1559,1332,740,170,570,79438,36,047,056900
36047057000,3576,2424,1534,1402,132,44375,36,047,057000
36047057100,3956,3376,1875,377,1498,63444,36,047,057100
36047057200,5222,1278,2126,0,2126,26652,36,047,057200
36047057300,2321,1904,1198,313,885,59417,36,047,057300
36047057400,2934,1318,1028,746,282,33553,36,047,057400
36047057500,3873,3085,2130,318,1812,62064,36,047,057500
36047057600,3005,1217,1036,557,479,46353,36,047,057600
36047057800,2827,1631,1099,403,696,37303,36,047,057800
36047057901,1149,775,486,44,442,54274,36,047,057901
36047057902,0,0,0,0,0,-666666666,36,047,057902
36047058000,4099,2042,1302,390,912,35583,36,047,058000
36047058200,2554,1059,859,252,607,40371,36,047,058200
36047058400,3530,2387,1389,443,946,41140,36,047,058400
36047058600,2689,750,956,508,448,35083,36,047,058600
36047058800,3357,2264,1430,653,777,50292,36,047,058800
36047058901,1624,1484,767,233,534,58911,36,047,058901
36047058902,0,0,0,0,0,-666666666,36,047,058902
36047059000,1722,855,633,261,372,37250,36,047,059000
36047059100,3595,3105,1772,251,1521,62386,36,047,059100
36047059200,4013,2381,1716,403,1313,48452,36,047,059200
36047059300,2121,1770,916,154,762,52904,36,047,059300
36047059402,5248,3772,2035,1492,543,53628,36,047,059402
36047059403,3367,1570,1291,621,670,35313,36,047,059403
36005023703,5662,855,1593,11,1582,23417,36,005,023703
36005023704,3838,259,1232,14,1218,19888,36,005,023704
36005023800,2281,566,756,287,469,32030,36,005,023800
36005023900,7947,795,2371,26,2345,20622,36,005,023900
36005024000,3932,1216,1290,477,813,30591,36,005,024000
36005024100,6546,1281,2274,56,2218,22291,36,005,024100
36005024300,5467,543,1918,42,1876,26111,36,005,024300
36005024400,2015,832,820,356,464,39570,36,005,024400
36005024501,4804,213,1396,26,1370,19684,36,005,024501
36005024502,3632,965,1203,23,1180,29806,36,005,024502
36005024600,2095,904,748,328,420,47804,36,005,024600
36005024700,1906,123,751,15,736,32433,36,005,024700
36005024800,3178,1972,1142,283,859,50065,36,005,024800
36005024900,0,0,0,0,0,-666666666,36,005,024900
36005025000,2604,1714,983,542,441,51711,36,005,025000
36005025100,6430,745,2180,491,1689,26108,36,005,025100
36005025200,2677,1345,936,356,580,35100,36,005,025200
36005025300,6155,546,1877,57,1820,26171,36,005,025300
36005025400,1912,1375,771,400,371,46250,36,005,025400
36005025500,7726,786,2398,141,2257,20555,36,005,025500
36005025600,1547,584,612,183,429,39455,36,005,025600
36005025700,1732,202,699,23,676,27019,36,005,025700
36005026100,1994,190,1108,928,180,57813,36,005,026100
36005026300,6314,1418,2341,101,2240,28007,36,005,026300
36005026400,5411,2693,1995,1029,966,34404,36,005,026400
36005026500,7426,1195,2140,49,2091,27003,36,005,026500
36005026601,3108,1457,1363,295,1068,47361,36,005,026601
36005026602,5229,2858,2469,524,1945,41734,36,005,026602
36005026701,3986,391,1281,24,1257,26464,36,005,026701
36005026702,7862,1703,2787,447,2340,23452,36,005,026702
36005026900,3652,1293,1735,175,1560,30076,36,005,026900
36005027300,7312,1671,2879,381,2498,22818,36,005,027300
36005027401,5042,4199,1733,1292,441,52917,36,005,027401
36005027402,3442,2368,1265,781,484,52336,36,005,027402
36005027600,261,187,146,0,146,-666666666,36,005,027600
36005027700,4503,1339,1816,57,1759,27801,36,005,027700
36005027900,7884,1966,2760,829,1931,32125,36,005,027900
36005023702,1395,181,414,6,408,26306,36,005,023702
36005028100,3799,1650,1746,926,820,43472,36,005,028100
36005028300,2086,728,838,35,803,23992,36,005,028300
36005028400,527,332,0,0,0,-666666666,36,005,028400
36005028500,3538,1837,1697,466,1231,38286,36,005,028500
36005028600,949,584,470,215,255,64926,36,005,028600
36005028700,3246,1272,1227,281,946,37236,36,005,028700
36005028800,3251,2333,1074,577,497,46364,36,005,028800
36005028900,4609,1935,1824,267,1557,36448,36,005,028900
36029014601,5522,5153,2326,1855,471,48963,36,029,014601
36029014603,4466,4013,1689,1597,92,52050,36,029,014603
36029014605,3793,3627,1480,1187,293,58629,36,029,014605
36029014606,4199,3803,1645,1465,180,98631,36,029,014606
36029014701,5664,5533,2048,1931,117,50275,36,029,014701
36029014703,5023,4675,1641,1573,68,53807,36,029,014703
36029014704,3953,3900,1885,1403,482,51165,36,029,014704
36029014801,2418,2297,1108,572,536,29227,36,029,014801
36029014804,3892,3835,1701,1390,311,45221,36,029,014804
36029014805,2372,2189,913,783,130,37174,36,029,014805
36029014901,2565,2475,1112,791,321,32821,36,029,014901
36029014903,5884,5556,2130,1883,247,40242,36,029,014903
36029015001,5386,4967,2149,1997,152,46156,36,029,015001
36029015002,3002,2935,1274,1210,64,39648,36,029,015002
36029015003,3350,3268,1471,1166,305,30724,36,029,015003
36029015101,3324,3266,1328,1160,168,44417,36,029,015101
36029015102,2785,2720,1102,915,187,46875,36,029,015102
36029015201,3381,3343,1588,1348,240,41509,36,029,015201
36029015202,4674,4495,2315,1940,375,44225,36,029,015202
36029015301,4614,4413,1869,1557,312,43479,36,029,015301
36029015302,3007,2901,1302,1077,225,39757,36,029,015302
36029015401,2831,2658,1192,867,325,34067,36,029,015401
36029015402,4669,4647,1846,1553,293,35677,36,029,015402
36029015501,2787,2630,1034,747,287,34479,36,029,015501
36029015503,2460,2271,1073,825,248,35938,36,029,015503
36029015504,3374,3315,1563,1383,180,37792,36,029,015504
36029015600,2027,1864,872,681,191,29877,36,029,015600
36029015700,3495,3389,1377,1135,242,34571,36,029,015700
36029015800,4175,4117,1799,1628,171,36706,36,029,015800
36029015900,4290,4208,1797,1018,779,37088,36,029,015900
36029016200,2319,1964,939,570,369,28182,36,029,016200
36029016300,1889,1306,734,378,356,14581,36,029,016300
36029016400,2783,1295,1431,478,953,29857,36,029,016400
36029016500,1738,1047,833,139,694,48370,36,029,016500
36029016600,2776,268,1142,607,535,20657,36,029,016600
36029016700,2191,1670,1152,650,502,28407,36,029,016700
36029016801,1794,103,988,512,476,18857,36,029,016801
36029016802,1948,28,682,270,412,25137,36,029,016802
36029016900,4151,2548,1582,617,965,26095,36,029,016900
36029017000,2661,55,1248,882,366,27147,36,029,017000
36029017100,3701,1573,1281,427,854,27625,36,029,017100
36029017200,2123,2007,1028,506,522,34092,36,029,017200
36029017301,2761,2671,1168,1027,141,44333,36,029,017301
36029017302,4375,4316,1851,1297,554,35362,36,029,017302
36029017400,4311,2153,1467,692,775,23412,36,029,017400
36029017501,1575,1517,618,394,224,28565,36,029,017501
36047059404,3811,2453,1580,713,867,34850,36,047,059404
36047059600,2264,1880,1176,780,396,45109,36,047,059600
36047059800,3526,2792,1377,623,754,42330,36,047,059800
36047060000,5963,4885,2524,1299,1225,52011,36,047,060000
36047060600,2830,1945,1255,642,613,42539,36,047,060600
36047060800,3673,2663,1630,392,1238,43520,36,047,060800
36047061002,5035,4955,2470,1161,1309,58231,36,047,061002
36047061003,1705,654,566,203,363,26023,36,047,061003
36047061004,5913,4904,2725,411,2314,33204,36,047,061004
36047061200,1062,999,411,323,88,54315,36,047,061200
36047061600,1424,1331,494,424,70,65263,36,047,061600
36047062000,1847,1786,708,483,225,42969,36,047,062000
36047062200,2540,1814,985,272,713,52028,36,047,062200
36047062600,2776,1704,1053,729,324,44543,36,047,062600
36047062800,4702,4130,1634,1474,160,57365,36,047,062800
36047063200,1497,1186,617,492,125,53750,36,047,063200
36047063600,1242,881,409,384,25,53688,36,047,063600
36047063800,2048,1453,758,488,270,53516,36,047,063800
36047064000,1623,1491,553,505,48,54659,36,047,064000
36047064200,2243,1732,844,357,487,49569,36,047,064200
36047064400,2980,1941,862,556,306,39681,36,047,064400
36047064600,1996,1435,671,541,130,53938,36,047,064600
36047064800,2349,1582,653,522,131,46875,36,047,064800
36047065000,1542,530,505,304,201,40105,36,047,065000
36047065200,1076,993,460,391,69,58125,36,047,065200
36047065400,1451,1136,542,468,74,60603,36,047,065400
36047065600,1752,1358,644,553,91,58875,36,047,065600
36047065800,1740,1265,649,554,95,70302,36,047,065800
36047066000,2067,1535,727,633,94,67240,36,047,066000
36047066200,1326,964,574,454,120,43162,36,047,066200
36047066600,0,0,0,0,0,-666666666,36,047,066600
36047067000,2888,784,1074,560,514,52072,36,047,067000
36047067200,1832,232,570,456,114,51372,36,047,067200
36047067400,1848,350,553,408,145,41961,36,047,067400
36047067600,1773,119,545,303,242,31454,36,047,067600
36047067800,3122,278,952,565,387,34094,36,047,067800
36047068000,2153,184,680,476,204,46625,36,047,068000
36047068200,2480,487,885,669,216,42292,36,047,068200
36047068600,1596,848,625,444,181,60293,36,047,068600
36047068800,1796,362,677,508,169,52902,36,047,068800
36047069000,1994,333,599,420,179,43320,36,047,069000
36047069200,2434,259,838,647,191,53663,36,047,069200
36047069601,3114,1429,1315,527,788,48068,36,047,069601
36047069602,5247,3457,2065,1615,450,61793,36,047,069602
36047069800,1351,670,422,400,22,54000,36,047,069800
36047070000,1419,1226,673,332,341,46629,36,047,070000
36047070201,5690,5064,2214,1899,315,83145,36,047,070201
36005029301,1772,1349,861,738,123,95179,36,005,029301
36005029302,5546,4238,2666,1639,1027,61375,36,005,029302
36005029500,4401,2427,2115,1061,1054,61689,36,005,029500
36005029600,1807,957,838,151,687,45313,36,005,029600
36005029700,3946,3054,1793,959,834,73571,36,005,029700
36005030000,6407,2921,2505,840,1665,43464,36,005,030000
36005030100,1463,970,635,323,312,70594,36,005,030100
36005030201,3813,580,1572,837,735,32436,36,005,030201
36005030202,5128,208,2456,1034,1422,42284,36,005,030202
36005030701,5826,4110,2357,973,1384,68304,36,005,030701
36005030900,4392,3459,1427,681,746,42500,36,005,030900
36005031000,4552,1894,1308,932,376,47077,36,005,031000
36005031200,1531,648,560,326,234,53516,36,005,031200
36005031400,2085,1062,632,430,202,45526,36,005,031400
36005031600,1978,873,684,359,325,44181,36,005,031600
36005031800,2215,849,565,370,195,42181,36,005,031800
36005031900,141,69,0,0,0,2499,36,005,031900
36005032300,4429,3211,2592,1744,848,62539,36,005,032300
36005032400,3286,653,1189,174,1015,16813,36,005,032400
36005032600,3695,1335,1037,498,539,41648,36,005,032600
36005032800,3989,945,1475,176,1299,32988,36,005,032800
36005033000,5456,2788,2132,187,1945,38427,36,005,033000
36005033201,5303,2650,2551,448,2103,33682,36,005,033201
36005033202,3821,930,1645,407,1238,40918,36,005,033202
36005033400,13,2,4,4,0,-666666666,36,005,033400
36005033500,2042,1473,703,412,291,29850,36,005,033500
36005033601,5121,977,2123,83,2040,30913,36,005,033601
36005033602,1678,224,676,283,393,30250,36,005,033602
36005033700,2632,1942,934,657,277,59457,36,005,033700
36005033801,2261,360,791,215,576,35938,36,005,033801
36005033802,1687,317,551,19,532,21334,36,005,033802
36005034000,5683,1192,1821,357,1464,30784,36,005,034000
36005034200,1698,186,601,313,288,37463,36,005,034200
36005034300,1660,639,570,204,366,45000,36,005,034300
36005034400,2202,306,626,387,239,33065,36,005,034400
36005034500,3278,1853,1287,600,687,61708,36,005,034500
36005034800,5914,696,2078,764,1314,38863,36,005,034800
36005035000,2127,296,715,345,370,35833,36,005,035000
36005035100,3719,2388,1267,504,763,31774,36,005,035100
36005035600,2171,169,705,457,248,41161,36,005,035600
36005035800,8591,1147,2816,1861,955,42366,36,005,035800
36005035900,2107,212,781,38,743,21916,36,005,035900
36005036000,3118,631,943,744,199,45726,36,005,036000
36005036100,5827,1219,2071,25,2046,23150,36,005,036100
36005036300,7021,1619,2369,162,2207,21046,36,005,036300
36005036400,2618,66,868,493,375,30915,36,005,036400
36029017502,2063,2004,844,751,93,35928,36,029,017502
36029940000,2022,164,784,591,193,30024,36,029,940000
36029940100,13,0,3,3,0,-666666666,36,029,940100
36029980000,2047,597,0,0,0,3352,36,029,980000
36029980300,2769,1049,16,4,12,6139,36,029,980300
36029980400,1502,674,0,0,0,-666666666,36,029,980400
36029980500,1026,445,22,22,0,3395,36,029,980500
36029990000,0,0,0,0,0,-666666666,36,029,990000
36031960100,2200,2127,972,744,228,29146,36,031,960100
36031960200,2550,2497,1083,952,131,35061,36,031,960200
36031960300,2714,2670,1265,1050,215,41111,36,031,960300
36031960401,1061,1014,509,219,290,35236,36,031,960401
36031960402,1416,1359,608,365,243,23295,36,031,960402
36031960501,2108,2032,943,655,288,31674,36,031,960501
36031960502,3590,2403,747,528,219,-666666666,36,031,960502
36031960700,1649,1586,765,676,89,34861,36,031,960700
36031960800,1979,1803,898,779,119,32813,36,031,960800
36031960901,1456,1273,665,478,187,28833,36,031,960901
36031960902,1821,1761,877,684,193,31731,36,031,960902
36031961001,1234,1088,680,556,124,33196,36,031,961001
36031961002,3302,3027,1412,1046,366,30781,36,031,961002
36031961100,2029,2003,854,704,150,36399,36,031,961100
36031961201,1867,1851,956,711,245,34422,36,031,961201
36031961202,2923,2855,1321,833,488,43371,36,031,961202
36031961300,1825,1805,893,728,165,31458,36,031,961300
36031961400,1557,1505,734,655,79,31333,36,031,961400
36033940000,3314,453,1226,982,244,41750,36,033,940000
36033950200,4842,4150,1930,1361,569,27020,36,033,950200
36033950301,5050,4684,1976,1430,546,31063,36,033,950301
36033950501,3437,3368,1397,684,713,25896,36,033,950501
36033950502,5946,2950,872,793,79,32038,36,033,950502
36033950601,1148,1061,533,451,82,37061,36,033,950601
36033950701,1266,1221,591,477,114,32708,36,033,950701
36033950800,2428,2250,811,695,116,16795,36,033,950800
36033950900,3396,2860,1546,933,613,34399,36,033,950900
36033951000,2100,2067,938,611,327,36184,36,033,951000
36033951100,3374,3104,1345,914,431,38633,36,033,951100
36033951200,2390,2224,1096,780,316,40775,36,033,951200
36033951300,1580,1463,564,467,97,36344,36,033,951300
36033951400,4916,4698,2023,1439,584,40513,36,033,951400
36033952000,5202,4899,2032,1590,442,35770,36,033,952000
36035970100,2556,2534,1153,831,322,24821,36,035,970100
36035970200,2867,2789,1158,929,229,39591,36,035,970200
36035970300,3356,3157,1463,1185,278,35759,36,035,970300
36035970400,1678,1523,789,704,85,35077,36,035,970400
36035970500,4014,3817,1620,1415,205,35038,36,035,970500
36047070203,0,0,0,0,0,-666666666,36,047,070203
36047070601,3062,2506,905,743,162,73438,36,047,070601
36047070602,0,0,0,0,0,-666666666,36,047,070602
36047072000,2005,119,646,245,401,44018,36,047,072000
36047072200,3067,85,1004,675,329,37296,36,047,072200
36047072400,1883,89,765,498,267,43750,36,047,072400
36047072600,2421,73,650,591,59,39878,36,047,072600
36047072800,3787,98,1623,1203,420,52205,36,047,072800
36047073000,2526,323,795,636,159,41993,36,047,073000
36047073200,2162,91,785,429,356,39547,36,047,073200
36047073400,1698,49,537,424,113,39237,36,047,073400
36047073600,3383,187,1203,580,623,35778,36,047,073600
36047073800,3606,1305,1303,630,673,30345,36,047,073800
36047074000,3649,341,1020,321,699,28667,36,047,074000
36047074200,3051,1416,968,489,479,38427,36,047,074200
36047074400,2611,2293,632,553,79,53935,36,047,074400
36047074600,2654,1906,747,418,329,41692,36,047,074600
36047074800,1867,1377,685,378,307,48393,36,047,074800
36047075000,2688,2071,882,427,455,42150,36,047,075000
36047075200,1007,995,284,264,20,53971,36,047,075200
36047075400,1225,1207,463,328,135,51071,36,047,075400
36047075600,2027,1734,805,525,280,60874,36,047,075600
36047075800,1555,1330,605,321,284,34792,36,047,075800
36047076000,2695,2421,1105,479,626,38864,36,047,076000
36047076200,4729,2250,1612,235,1377,32020,36,047,076200
36047076400,3607,1386,1495,166,1329,40833,36,047,076400
36047076600,2056,414,682,180,502,34393,36,047,076600
36047076800,3575,3014,1195,451,744,35389,36,047,076800
36047077000,2672,518,1057,431,626,41078,36,047,077000
36047077200,3250,1423,1207,547,660,52298,36,047,077200
36047077400,3321,614,1307,172,1135,42388,36,047,077400
36047077600,3707,518,1781,1064,717,54545,36,047,077600
36047078000,2260,92,652,466,186,44515,36,047,078000
36047078200,4667,67,1663,392,1271,34241,36,047,078200
36047078400,2316,144,805,447,358,43900,36,047,078400
36047078601,2399,260,1057,284,773,43486,36,047,078601
36047078602,2100,157,827,295,532,31906,36,047,078602
36047070202,26,16,13,0,13,80833,36,047,070202
36047078801,2020,181,780,138,642,27520,36,047,078801
36047078802,1639,0,513,5,508,31565,36,047,078802
36047079001,1701,160,452,86,366,45847,36,047,079001
36047079002,3214,58,1181,340,841,42610,36,047,079002
36047079201,1161,119,462,134,328,35880,36,047,079201
36047079202,2350,105,750,199,551,39365,36,047,079202
36047079400,1758,171,567,233,334,31914,36,047,079400
36047079601,3630,1039,1687,269,1418,43597,36,047,079601
36005036501,3986,713,1371,98,1273,27036,36,005,036501
36005036502,2482,223,758,37,721,20657,36,005,036502
36005036700,2140,331,632,141,491,25125,36,005,036700
36005036800,2204,121,570,282,288,32688,36,005,036800
36005036901,2041,295,766,68,698,22196,36,005,036901
36005036902,2086,562,779,22,757,20875,36,005,036902
36005037000,2316,105,700,505,195,35232,36,005,037000
36005037100,4242,1141,1795,142,1653,25342,36,005,037100
36005037200,2174,378,829,231,598,35600,36,005,037200
36005037300,6191,608,1899,227,1672,21155,36,005,037300
36005037400,3692,429,1494,197,1297,20707,36,005,037400
36005037504,3361,1276,1220,25,1195,18143,36,005,037504
36005037600,2267,172,775,273,502,39407,36,005,037600
36005037800,3150,185,1070,151,919,28064,36,005,037800
36005037900,5548,423,1514,67,1447,19901,36,005,037900
36005038000,5245,376,1975,714,1261,26299,36,005,038000
36005038100,7876,2431,2513,111,2402,21763,36,005,038100
36005038200,3017,189,971,526,445,38480,36,005,038200
36005038301,5034,400,1641,32,1609,24053,36,005,038301
36005038303,3701,344,1282,42,1240,22750,36,005,038303
36005038304,2398,391,795,38,757,-666666666,36,005,038304
36005038500,4399,330,1635,49,1586,20281,36,005,038500
36005038600,9481,148,2834,919,1915,33493,36,005,038600
36005038700,3679,480,1259,29,1230,24295,36,005,038700
36005038800,2888,274,925,532,393,34597,36,005,038800
36005038900,5331,1598,1821,40,1781,21809,36,005,038900
36005039000,2853,118,1093,183,910,32281,36,005,039000
36005039100,7559,1944,2756,203,2553,22439,36,005,039100
36005039200,1648,80,635,161,474,40648,36,005,039200
36005039300,8150,1018,3057,99,2958,31660,36,005,039300
36005039400,5369,646,1677,380,1297,33331,36,005,039400
36005039500,4157,586,1592,190,1402,24300,36,005,039500
36005039600,4519,482,1381,319,1062,27377,36,005,039600
36005039700,3603,2354,548,5,543,4029,36,005,039700
36005039800,4152,287,1209,573,636,35882,36,005,039800
36005039901,5639,685,1705,10,1695,19743,36,005,039901
36005039902,5574,417,1701,9,1692,25825,36,005,039902
36005040100,4597,540,1832,11,1821,23102,36,005,040100
36005040302,5125,365,1580,11,1569,25039,36,005,040302
36005040303,4335,833,1357,82,1275,23157,36,005,040303
36005040304,3215,435,1202,25,1177,21667,36,005,040304
36005040400,3514,280,1100,620,480,45548,36,005,040400
36005040501,4128,170,1339,77,1262,23305,36,005,040501
36005040502,7293,516,2365,193,2172,26250,36,005,040502
36005040600,3613,437,1290,366,924,30538,36,005,040600
36005040701,3101,752,1217,6,1211,26920,36,005,040701
36035970601,4123,3752,1573,1393,180,37418,36,035,970601
36035970602,3203,3183,1303,1249,54,41719,36,035,970602
36035970700,3299,2899,1594,707,887,20625,36,035,970700
36035970800,3041,2757,1119,433,686,32212,36,035,970800
36035970900,3476,3047,1526,750,776,30332,36,035,970900
36035971000,2471,2228,957,609,348,25295,36,035,971000
36035971100,2484,2097,1036,509,527,25880,36,035,971100
36035971200,3869,3560,1684,883,801,33465,36,035,971200
36035971300,4367,4064,1962,1305,657,35437,36,035,971300
36035971400,3479,3184,1299,956,343,43556,36,035,971400
36035971501,2967,2903,1297,999,298,33819,36,035,971501
36035971502,2202,2202,873,755,118,27115,36,035,971502
36037940100,361,38,203,148,55,22177,36,037,940100
36037950100,5058,4883,1942,1661,281,40845,36,037,950100
36037950200,5099,4642,1935,1471,464,32523,36,037,950200
36037950301,2920,2735,1219,870,349,36182,36,037,950301
36037950302,3149,2906,1242,1023,219,38154,36,037,950302
36037950401,3082,3045,1479,1225,254,33322,36,037,950401
36037950402,3802,3668,1611,1444,167,38208,36,037,950402
36037950501,1417,1224,598,401,197,31596,36,037,950501
36037950502,937,741,473,125,348,35694,36,037,950502
36037950600,1617,1257,741,413,328,36513,36,037,950600
36037950700,2243,2006,1050,414,636,42500,36,037,950700
36037950800,3495,2832,1381,651,730,25645,36,037,950800
36037950900,2387,2181,1209,688,521,36774,36,037,950900
36037951000,2394,1894,1042,480,562,26422,36,037,951000
36037951100,4947,4733,2107,1818,289,40054,36,037,951100
36037951200,4625,4371,2115,1421,694,32892,36,037,951200
36037951300,4214,3854,1697,1370,327,37923,36,037,951300
36037951400,5807,5640,2130,1878,252,37483,36,037,951400
36039080100,3256,3091,1147,1027,120,33503,36,039,080100
36039080201,3562,3371,1427,1300,127,37133,36,039,080201
36039080202,2654,2251,939,709,230,27488,36,039,080202
36039080301,1605,1445,627,530,97,25481,36,039,080301
36039080302,1482,1429,635,555,80,32401,36,039,080302
36039080402,1974,1765,830,770,60,37321,36,039,080402
36039080403,854,854,386,196,190,-666666666,36,039,080403
36039080404,1775,1743,564,368,196,35117,36,039,080404
36039080501,2739,2435,1061,834,227,39568,36,039,080501
36039080502,3692,3381,1316,945,371,31071,36,039,080502
36039080600,3102,2840,1105,957,148,43281,36,039,080600
36039080700,2744,2715,1192,749,443,48750,36,039,080700
36039080800,2592,1089,0,0,0,-666666666,36,039,080800
36039080900,3940,3706,1585,1326,259,40057,36,039,080900
36039081001,1874,1231,877,468,409,10024,36,039,081001
36039081002,2258,1913,1108,637,471,43871,36,039,081002
36047079602,4949,912,2140,308,1832,41400,36,047,079602
36047079801,3121,1255,1451,368,1083,50240,36,047,079801
36047079802,5197,1628,2433,52,2381,47219,36,047,079802
36047080000,3451,1053,1431,634,797,43529,36,047,080000
36047080200,4764,937,1982,712,1270,45534,36,047,080200
36047080400,3147,408,1469,443,1026,45855,36,047,080400
36047080600,3199,948,1292,299,993,32784,36,047,080600
36047080800,1668,293,580,3,577,-666666666,36,047,080800
36047081000,2202,317,913,188,725,38412,36,047,081000
36047081400,2485,173,965,400,565,31716,36,047,081400
36047081600,2594,188,1000,298,702,40199,36,047,081600
36047081800,4367,572,1716,354,1362,46715,36,047,081800
36047082000,5247,326,2168,31,2137,39408,36,047,082000
36047082200,7257,1038,2709,167,2542,39934,36,047,082200
36047082400,4789,217,1717,290,1427,33837,36,047,082400
36047082600,4428,165,1855,457,1398,36426,36,047,082600
36047082800,3797,174,1360,296,1064,41563,36,047,082800
36047083000,6560,186,2461,573,1888,46796,36,047,083000
36047083200,2000,3,737,442,295,37216,36,047,083200
36047083400,1524,11,576,379,197,45647,36,047,083400
36047083600,2048,0,694,452,242,40417,36,047,083600
36047083800,2113,16,754,588,166,40195,36,047,083800
36047084000,2703,34,830,551,279,36817,36,047,084000
36047084600,1899,117,715,465,250,46094,36,047,084600
36047084800,1594,6,557,322,235,43264,36,047,084800
36047085000,1609,3,467,367,100,31583,36,047,085000
36047085200,24,0,4,4,0,56000,36,047,085200
36047085400,1994,96,807,371,436,41767,36,047,085400
36047085600,3649,149,1470,379,1091,34792,36,047,085600
36047085800,2049,26,765,416,349,39980,36,047,085800
36047086000,3480,12,1328,524,804,36955,36,047,086000
36047086200,2832,158,1259,305,954,40401,36,047,086200
36047086400,2517,0,795,351,444,43339,36,047,086400
36047086600,3106,111,1149,401,748,40224,36,047,086600
36047086800,3531,10,1449,272,1177,28870,36,047,086800
36047087000,2950,126,1114,366,748,31759,36,047,087000
36047087200,2836,318,1044,480,564,43094,36,047,087200
36047087401,3982,286,1510,232,1278,35669,36,047,087401
36047087600,1770,361,761,329,432,40281,36,047,087600
36047087800,2296,9,985,118,867,33697,36,047,087800
36047088001,1887,47,666,302,364,46705,36,047,088001
36047088002,1225,178,448,223,225,44854,36,047,088002
36047088200,6152,1041,2315,475,1840,35041,36,047,088200
36047088400,4707,83,1749,314,1435,30292,36,047,088400
36047088600,3873,228,1918,178,1740,24409,36,047,088600
36047088800,4060,42,1564,366,1198,32772,36,047,088800
36047089000,5789,181,2208,232,1976,39918,36,047,089000
36005040702,6641,1047,2754,98,2656,24113,36,005,040702
36005040800,4709,540,1733,225,1508,28654,36,005,040800
36005040900,3292,702,1375,363,1012,39306,36,005,040900
36005041100,3565,834,1285,146,1139,24968,36,005,041100
36005041300,8904,1355,3069,211,2858,28077,36,005,041300
36005041400,5206,646,1787,625,1162,28237,36,005,041400
36005041500,6103,876,2425,63,2362,25254,36,005,041500
36005041800,3555,643,1208,290,918,41890,36,005,041800
36005041900,6090,1763,2465,36,2429,26029,36,005,041900
36005042000,4260,747,1654,94,1560,32417,36,005,042000
36005042100,5522,1660,2038,131,1907,31977,36,005,042100
36005042200,2864,133,1153,550,603,36507,36,005,042200
36005042300,4033,1542,1289,30,1259,31378,36,005,042300
36005042400,2608,588,798,462,336,37326,36,005,042400
36005042500,6248,2677,2050,24,2026,24909,36,005,042500
36005042600,7161,238,2178,1269,909,36671,36,005,042600
36005042800,1976,165,762,523,239,37133,36,005,042800
36005042901,3224,1032,1319,70,1249,25521,36,005,042901
36005042902,3865,548,1648,130,1518,27372,36,005,042902
36005043000,3496,312,1217,700,517,43295,36,005,043000
36005043101,5693,1777,1757,51,1706,22461,36,005,043101
36005043102,4615,812,1756,229,1527,23017,36,005,043102
36005043400,3796,486,1364,550,814,37091,36,005,043400
36005043501,757,95,336,0,336,33981,36,005,043501
36005043502,0,0,0,0,0,-666666666,36,005,043502
36005043503,0,0,0,0,0,-666666666,36,005,043503
36005043600,1927,139,700,388,312,43590,36,005,043600
36005044200,4022,426,1312,665,647,26667,36,005,044200
36005044400,4472,463,1435,886,549,34358,36,005,044400
36005044800,2068,94,661,460,201,47418,36,005,044800
36005044901,1762,1379,766,369,397,54965,36,005,044901
36005044902,2049,1298,882,314,568,44375,36,005,044902
36005045101,1521,1290,859,233,626,61538,36,005,045101
36005045102,2086,1757,855,339,516,61349,36,005,045102
36005045600,3401,792,1077,755,322,59722,36,005,045600
36005045800,5538,783,2036,0,2036,20645,36,005,045800
36005046000,3131,282,1001,121,880,20685,36,005,046000
36005046203,7679,1995,3193,1536,1657,44873,36,005,046203
36005046204,6569,407,2424,1269,1155,44230,36,005,046204
36005046205,2898,234,1909,714,1195,41403,36,005,046205
36005046206,4137,1282,1998,846,1152,50197,36,005,046206
36005046207,6450,493,2977,1951,1026,46669,36,005,046207
36005046208,5586,328,1460,629,831,40514,36,005,046208
36005046209,4739,383,1447,169,1278,30357,36,005,046209
36005048401,4062,213,1272,605,667,40639,36,005,048401
36005048402,0,0,0,0,0,-666666666,36,005,048402
36039081101,4516,4260,1879,1426,453,39981,36,039,081101
36039081102,2716,2352,1003,753,250,30670,36,039,081102
36041950100,576,554,239,219,20,29583,36,041,950100
36041950300,992,928,369,319,50,31566,36,041,950300
36041950400,1961,1879,544,448,96,35101,36,041,950400
36041950500,925,868,264,222,42,26167,36,041,950500
36043010100,6035,5931,2239,1838,401,31200,36,043,010100
36043010201,3521,3146,1457,1208,249,33995,36,043,010201
36043010202,3705,3545,1458,1251,207,37413,36,043,010202
36043010300,5854,5588,2407,1678,729,44214,36,043,010300
36043010400,2737,2359,1149,588,561,32691,36,043,010400
36043010501,2575,2299,1035,709,326,33434,36,043,010501
36043010502,1422,1280,574,514,60,35066,36,043,010502
36043010701,2443,2339,874,487,387,25691,36,043,010701
36043010702,2230,2212,911,607,304,27175,36,043,010702
36043010900,3386,3279,1238,1106,132,37669,36,043,010900
36043011001,2349,2308,921,514,407,27500,36,043,011001
36043011002,3084,2887,1226,1117,109,35149,36,043,011002
36043011100,2473,2102,1114,460,654,31598,36,043,011100
36043011200,5533,5170,2517,1534,983,32766,36,043,011200
36043011301,1654,1626,741,646,95,47333,36,043,011301
36043011302,3336,3196,1463,1105,358,34681,36,043,011302
36043011400,4559,4476,1685,1428,257,36264,36,043,011400
36043011502,1646,1615,751,648,103,37985,36,043,011502
36043011503,1921,1913,798,707,91,37740,36,043,011503
36043011504,1275,1247,535,502,33,30750,36,043,011504
36045060101,2123,2082,788,755,33,28073,36,045,060101
36045060102,1788,1725,932,681,251,41705,36,045,060102
36045060201,2058,1980,985,704,281,47292,36,045,060201
36045060202,2821,2110,897,646,251,26607,36,045,060202
36045060203,2296,2282,739,640,99,27885,36,045,060203
36045060301,1415,1338,635,549,86,27411,36,045,060301
36045060302,2008,1849,754,672,82,31935,36,045,060302
36045060401,3554,3493,1469,1208,261,30669,36,045,060401
36045060402,2648,2544,1220,693,527,46713,36,045,060402
36045060500,5129,4078,1903,1236,667,36574,36,045,060500
36045060601,2947,2714,1141,659,482,32672,36,045,060601
36045060602,3075,1907,1311,197,1114,29741,36,045,060602
36045060700,4765,4480,1835,1265,570,30227,36,045,060700
36045060803,7206,4319,2132,53,2079,27467,36,045,060803
36045060805,3643,2482,893,8,885,27633,36,045,060805
36045060806,3187,2186,561,114,447,25088,36,045,060806
36045060901,2774,2495,1245,483,762,33992,36,045,060901
36045060902,2932,2474,1051,720,331,40139,36,045,060902
36045061000,3268,2762,1396,706,690,31684,36,045,061000
36047089200,3224,84,1628,57,1571,28083,36,047,089200
36047089400,3245,148,1079,414,665,30851,36,047,089400
36047089600,3041,259,1689,194,1495,37784,36,047,089600
36047089800,1907,100,664,155,509,34349,36,047,089800
36047090000,4158,367,1758,293,1465,26144,36,047,090000
36047090200,3149,450,797,259,538,25676,36,047,090200
36047090600,3311,316,1750,13,1737,31211,36,047,090600
36047090800,5408,931,1314,8,1306,18876,36,047,090800
36047091000,4199,608,2395,0,2395,20557,36,047,091000
36047091200,5549,346,2345,19,2326,30449,36,047,091200
36047091600,3196,221,1571,168,1403,28304,36,047,091600
36047091800,2168,155,1072,466,606,49125,36,047,091800
36047092000,2227,29,1139,503,636,22760,36,047,092000
36047092200,2390,357,1265,256,1009,28314,36,047,092200
36047092400,2176,172,905,115,790,31667,36,047,092400
36047092800,2764,26,1143,427,716,46848,36,047,092800
36047093000,3107,21,1037,660,377,38417,36,047,093000
36047093200,1037,49,468,320,148,34167,36,047,093200
36047093400,2495,63,1052,580,472,48177,36,047,093400
36047093600,1596,14,693,479,214,41058,36,047,093600
36047093800,2556,54,952,381,571,39566,36,047,093800
36047094401,3378,90,1176,663,513,46008,36,047,094401
36047094402,3127,180,1330,0,1330,29732,36,047,094402
36047094600,2103,7,706,553,153,45132,36,047,094600
36047095000,2442,225,917,476,441,45991,36,047,095000
36047095400,4082,39,1576,826,750,52840,36,047,095400
36047095600,4434,382,1502,589,913,41261,36,047,095600
36047095800,3109,257,1155,579,576,37003,36,047,095800
36047096000,0,0,0,0,0,-666666666,36,047,096000
36047096200,1833,112,473,257,216,39039,36,047,096200
36047096400,2034,122,751,434,317,49879,36,047,096400
36047096600,2759,40,816,435,381,37538,36,047,096600
36047096800,1549,22,423,285,138,41611,36,047,096800
36047097000,2713,299,808,385,423,40341,36,047,097000
36047097400,2723,292,691,391,300,40927,36,047,097400
36047098200,4532,193,1702,0,1702,27773,36,047,098200
36047098400,2163,98,691,414,277,40143,36,047,098400
36047098600,2664,83,978,436,542,41755,36,047,098600
36047098800,3328,245,1096,476,620,45941,36,047,098800
36047099000,1697,119,517,306,211,52222,36,047,099000
36047099200,2266,92,718,482,236,44364,36,047,099200
36047099400,1996,54,645,359,286,42434,36,047,099400
36047099600,3762,157,1138,562,576,42031,36,047,099600
36047099800,3624,239,1277,628,649,42905,36,047,099800
36047100400,2642,150,972,457,515,46818,36,047,100400
36047100600,2737,200,925,613,312,43602,36,047,100600
36047100800,2091,166,661,332,329,44292,36,047,100800
36005050400,0,0,0,0,0,-666666666,36,005,050400
36005051601,4322,3031,1874,1154,720,61183,36,005,051601
36005051602,0,0,0,0,0,-666666666,36,005,051602
36007000100,3333,1867,1462,456,1006,14567,36,007,000100
36007000200,3277,2524,1552,758,794,27163,36,007,000200
36007000300,2482,1682,1227,372,855,38013,36,007,000300
36007000400,1795,1322,760,269,491,23906,36,007,000400
36007000500,1920,1101,923,208,715,17679,36,007,000500
36007000600,2326,1165,889,299,590,30689,36,007,000600
36007000700,3422,3051,1379,966,413,26722,36,007,000700
36007000900,1840,1342,824,246,578,28472,36,007,000900
36007001100,1689,959,901,55,846,15840,36,007,001100
36007001200,883,611,633,18,615,12174,36,007,001200
36007001300,3301,2107,918,63,855,9265,36,007,001300
36007001401,1537,1021,742,41,701,-666666666,36,007,001401
36007001402,2843,2353,1295,639,656,17171,36,007,001402
36007001500,4142,3560,1857,1348,509,40805,36,007,001500
36007001600,2001,1779,974,776,198,39716,36,007,001600
36007001700,4184,3449,2024,1080,944,27474,36,007,001700
36007001800,3844,2327,1692,667,1025,23777,36,007,001800
36007010200,5111,4845,2190,1990,200,35696,36,007,010200
36007011901,2786,2748,1169,838,331,31502,36,007,011901
36007011902,2610,2486,995,890,105,34977,36,007,011902
36007011903,2632,2597,1005,813,192,33977,36,007,011903
36007012000,1721,1650,695,581,114,28571,36,007,012000
36007012101,3625,3400,1401,1193,208,40739,36,007,012101
36007012102,3834,3570,1434,1299,135,44089,36,007,012102
36007012103,3160,3006,1244,946,298,36225,36,007,012103
36007012201,2249,2208,874,718,156,38679,36,007,012201
36007012202,4054,3864,1460,1154,306,30564,36,007,012202
36007012300,4991,4816,1929,1572,357,36611,36,007,012300
36007012400,2204,2124,957,814,143,36146,36,007,012400
36007012501,2446,2429,1296,1254,42,39620,36,007,012501
36007012502,3487,3424,1414,1192,222,35720,36,007,012502
36007012600,5539,4823,2239,1680,559,36622,36,007,012600
36007012701,5161,4939,2206,1828,378,35821,36,007,012701
36007012702,4753,4526,1797,1566,231,42000,36,007,012702
36007012800,5061,4414,1932,1415,517,25784,36,007,012800
36007012900,1557,1491,805,405,400,38646,36,007,012900
36007013000,4218,3745,1665,1499,166,44547,36,007,013000
36007013100,2468,2187,1223,579,644,31932,36,007,013100
36007013201,1968,1752,916,796,120,35492,36,007,013201
36007013202,3256,2966,1475,1052,423,40000,36,007,013202
36007013301,4456,3956,1988,1262,726,38911,36,007,013301
36007013303,2863,2666,1173,998,175,43250,36,007,013303
36007013304,5558,5125,2353,1968,385,50634,36,007,013304
36045061101,2456,2361,963,679,284,29461,36,045,061101
36045061102,2506,2318,1097,661,436,29806,36,045,061102
36045061200,3188,2546,1198,348,850,30378,36,045,061200
36045061300,3045,2604,1305,691,614,31960,36,045,061300
36045061400,3447,2849,1487,741,746,25107,36,045,061400
36045061500,4163,3440,1876,666,1210,27725,36,045,061500
36045061600,5061,4656,1882,1159,723,42825,36,045,061600
36045061700,2340,2207,1062,877,185,27609,36,045,061700
36045061801,3477,3352,1373,965,408,28824,36,045,061801
36045061802,3134,3042,1295,959,336,43382,36,045,061802
36045061900,3510,3202,1523,883,640,40705,36,045,061900
36045062100,3834,3005,2027,417,1610,24080,36,045,062100
36045062200,4037,3512,1701,812,889,31220,36,045,062200
36045062400,4489,3887,1317,1191,126,40721,36,045,062400
36045062500,3001,2929,1053,942,111,40532,36,045,062500
36045980000,129,84,0,0,0,23375,36,045,980000
36045990001,0,0,0,0,0,-666666666,36,045,990001
36047000100,4539,3084,2369,1178,1191,88993,36,047,000100
36047000200,992,446,340,44,296,25750,36,047,000200
36047000301,3642,3271,1786,999,787,121479,36,047,000301
36047000501,4486,3383,1934,1123,811,76603,36,047,000501
36047000502,2654,2226,1464,550,914,98021,36,047,000502
36047000700,3899,3303,1669,691,978,107117,36,047,000700
36047000900,4654,3591,2284,714,1570,107107,36,047,000900
36047001100,1502,1053,818,84,734,100398,36,047,001100
36047001300,1917,1273,1021,819,202,91480,36,047,001300
36047001501,4875,1594,2290,107,2183,55319,36,047,001501
36047001502,4654,1717,2230,413,1817,83306,36,047,001502
36047001801,1920,791,0,0,0,-666666666,36,047,001801
36047001802,0,0,0,0,0,-666666666,36,047,001802
36047001803,0,0,0,0,0,-666666666,36,047,001803
36047001804,0,0,0,0,0,-666666666,36,047,001804
36047002000,1503,611,388,79,309,21076,36,047,002000
36047002100,5206,3731,2062,969,1093,116921,36,047,002100
36047002200,4284,2358,1570,520,1050,31310,36,047,002200
36047002300,4133,384,1475,71,1404,19889,36,047,002300
36047002901,4528,352,1471,12,1459,17468,36,047,002901
36047003000,1545,923,684,365,319,46645,36,047,003000
36047003101,3468,1629,1257,621,636,72898,36,047,003101
36047003102,0,0,0,0,0,-666666666,36,047,003102
36047003300,4479,2156,2218,289,1929,78814,36,047,003300
36047003400,3306,2012,1305,713,592,62656,36,047,003400
36047003500,2080,1096,1115,202,913,80847,36,047,003500
36047003600,3465,2458,1800,696,1104,57147,36,047,003600
36047003700,2568,1428,1397,195,1202,96136,36,047,003700
36047003800,1335,817,559,361,198,70577,36,047,003800
36047101000,2376,107,872,424,448,41372,36,047,101000
36047101200,2261,48,869,443,426,46084,36,047,101200
36047101400,2143,158,814,505,309,47571,36,047,101400
36047101600,1599,53,520,396,124,56944,36,047,101600
36047101800,2228,64,800,643,157,52436,36,047,101800
36047102000,2285,74,728,489,239,52355,36,047,102000
36047102200,2157,407,762,407,355,41597,36,047,102200
36047102400,2323,113,710,420,290,43600,36,047,102400
36047102600,3001,103,944,493,451,42512,36,047,102600
36047102801,1652,47,522,351,171,46453,36,047,102801
36047102802,0,0,0,0,0,-666666666,36,047,102802
36047103401,3873,298,1713,0,1713,30783,36,047,103401
36047103402,0,0,0,0,0,-666666666,36,047,103402
36047105801,5847,1861,3581,34,3547,37168,36,047,105801
36047105804,6614,1382,3057,89,2968,34375,36,047,105804
36047107001,2613,244,1171,450,721,33500,36,047,107001
36047107002,0,0,0,0,0,-666666666,36,047,107002
36047107003,0,0,0,0,0,-666666666,36,047,107003
36047107800,4554,205,1932,1152,780,38425,36,047,107800
36047109800,2450,222,657,169,488,36875,36,047,109800
36047110400,4354,160,1722,543,1179,27370,36,047,110400
36047110600,4298,149,1868,0,1868,22379,36,047,110600
36047111000,2891,395,1378,0,1378,26611,36,047,111000
36047111600,3501,401,981,399,582,28058,36,047,111600
36047111800,3731,742,1380,346,1034,40401,36,047,111800
36047112000,3242,619,1110,335,775,31419,36,047,112000
36047112200,2986,118,1435,368,1067,31187,36,047,112200
36047112400,3293,160,1247,333,914,32583,36,047,112400
36047112600,3469,39,1618,328,1290,36645,36,047,112600
36047112800,3582,230,1343,399,944,47917,36,047,112800
36047113000,3806,322,1559,563,996,40335,36,047,113000
36047113200,1877,87,599,323,276,40175,36,047,113200
36047113400,2797,331,943,66,877,25067,36,047,113400
36047114201,1337,437,574,317,257,32917,36,047,114201
36047114202,3052,528,967,287,680,48222,36,047,114202
36047114400,2580,594,754,184,570,30000,36,047,114400
36047114600,2856,827,843,317,526,32269,36,047,114600
36047115000,2717,372,859,285,574,30147,36,047,115000
36047115200,3049,374,1015,261,754,35938,36,047,115200
36047115600,4181,235,1761,147,1614,23964,36,047,115600
36047115800,2760,254,982,439,543,31958,36,047,115800
36047116000,2630,258,889,307,582,27045,36,047,116000
36047116200,2706,33,840,342,498,40156,36,047,116200
36047116400,3507,490,1156,527,629,36489,36,047,116400
36047116600,2992,466,1018,265,753,32026,36,047,116600
36047116800,2118,869,671,111,560,35121,36,047,116800
36007013400,4235,3402,2023,886,1137,31929,36,007,013400
36007013500,1728,1164,611,202,409,20000,36,007,013500
36007013600,3575,2751,1584,721,863,27862,36,007,013600
36007013700,3146,2904,1710,774,936,31250,36,007,013700
36007013800,3084,2793,1429,1116,313,34316,36,007,013800
36007013900,2809,1885,1102,365,737,17422,36,007,013900
36007014000,2876,2051,1173,392,781,22917,36,007,014000
36007014100,2793,2279,1257,977,280,28196,36,007,014100
36007014200,2767,2292,1412,710,702,41875,36,007,014200
36007014301,5987,4045,2167,1373,794,23879,36,007,014301
36007014302,9022,6906,1395,660,735,3864,36,007,014302
36007014400,4865,4269,2176,1759,417,37716,36,007,014400
36007014500,3168,3078,1428,1196,232,42474,36,007,014500
36007014600,5400,4757,2174,2086,88,44219,36,007,014600
36009940000,201,13,54,54,0,45139,36,009,940000
36009940200,0,0,0,0,0,-666666666,36,009,940200
36009940301,2587,1433,1082,567,515,24219,36,009,940301
36009940302,3344,2297,1339,706,633,30152,36,009,940302
36009960100,3560,3421,1418,1231,187,32421,36,009,960100
36009960200,4285,4193,1848,1396,452,26370,36,009,960200
36009960300,4813,4635,2052,1768,284,32388,36,009,960300
36009960400,4515,4232,1790,1348,442,32778,36,009,960400
36009960500,4791,4652,1721,1400,321,34132,36,009,960500
36009960600,3607,3313,1492,1111,381,31618,36,009,960600
36009960703,1560,1514,704,635,69,33707,36,009,960703
36009960704,1006,974,448,379,69,36938,36,009,960704
36009960800,4001,3788,1618,1341,277,31841,36,009,960800
36009961000,4512,4265,2042,1627,415,32274,36,009,961000
36009961100,4335,4120,1866,1426,440,39969,36,009,961100
36009961200,3112,2964,1433,1006,427,41337,36,009,961200
36009961301,2479,2315,1155,954,201,31604,36,009,961301
36009961302,2591,2240,592,392,200,5743,36,009,961302
36009961400,4844,4706,2005,1582,423,33915,36,009,961400
36009961500,2132,2003,930,613,317,40103,36,009,961500
36009961600,3682,3412,1620,1008,612,27182,36,009,961600
36009961700,3367,2910,1719,474,1245,24563,36,009,961700
36009961800,4399,4017,1817,964,853,35625,36,009,961800
36009962200,3027,2843,1254,1108,146,36065,36,009,962200
36011040101,1804,1539,577,512,65,34861,36,011,040101
36011040102,3021,2986,1147,970,177,29761,36,011,040102
36011040201,2426,2372,972,849,123,37188,36,011,040201
36011040202,2375,2317,855,733,122,40799,36,011,040202
36011040300,4119,3981,1621,1315,306,30167,36,011,040300
36011040400,4258,4145,1887,1392,495,41379,36,011,040400
36011040500,3366,3208,1288,1109,179,34479,36,011,040500
36047003900,2340,1331,1030,323,707,71830,36,047,003900
36047004100,3606,2889,1312,447,865,94228,36,047,004100
36047004300,3662,2443,1710,453,1257,90827,36,047,004300
36047004400,2328,2118,960,732,228,66714,36,047,004400
36047004500,3574,2677,1564,620,944,85547,36,047,004500
36047004600,1282,1161,538,410,128,66397,36,047,004600
36047004700,1841,1174,735,263,472,83313,36,047,004700
36047004900,2660,1846,996,423,573,100625,36,047,004900
36047005000,2243,1878,966,588,378,70913,36,047,005000
36047005100,2815,2104,1084,510,574,80956,36,047,005100
36047005201,1603,1122,964,211,753,80750,36,047,005201
36047005202,2501,2268,1337,735,602,81579,36,047,005202
36047005301,2223,1536,902,317,585,58603,36,047,005301
36047005302,65,43,32,0,32,-666666666,36,047,005302
36047005303,0,0,0,0,0,-666666666,36,047,005303
36047005400,3297,2362,1632,506,1126,52128,36,047,005400
36047005601,2421,1784,1266,626,640,65369,36,047,005601
36047005602,1787,1302,915,481,434,72237,36,047,005602
36047005800,2932,2141,1325,342,983,42411,36,047,005800
36047005900,1143,795,537,42,495,56131,36,047,005900
36047006000,3262,2241,1089,349,740,42391,36,047,006000
36047006200,2625,1841,1065,263,802,51480,36,047,006200
36047006300,1999,1668,926,282,644,94551,36,047,006300
36047006400,2996,2353,1299,569,730,57173,36,047,006400
36047006500,5846,5264,2400,1075,1325,86469,36,047,006500
36047006600,3625,2812,1646,411,1235,51000,36,047,006600
36047006700,3980,3405,1525,685,840,94813,36,047,006700
36047006800,4559,2504,1694,419,1275,33843,36,047,006800
36047006901,1732,1549,845,235,610,85278,36,047,006901
36047006902,2182,1724,903,269,634,74353,36,047,006902
36047007000,2392,1546,1088,684,404,60397,36,047,007000
36047007100,4430,1395,1728,276,1452,25091,36,047,007100
36047007200,1738,743,529,80,449,30374,36,047,007200
36047007400,5328,1774,1538,287,1251,27188,36,047,007400
36047007500,4798,3786,2077,856,1221,85113,36,047,007500
36047007600,5431,2243,1382,358,1024,27128,36,047,007600
36047007700,5330,4174,2427,1077,1350,86514,36,047,007700
36047007800,4873,2503,1409,222,1187,29860,36,047,007800
36047008000,3627,2144,1208,452,756,36210,36,047,008000
36047008200,3627,1179,1392,236,1156,46403,36,047,008200
36047008400,3635,1660,1240,262,978,27210,36,047,008400
36047008500,7577,978,3076,0,3076,21384,36,047,008500
36047008600,0,0,0,0,0,-666666666,36,047,008600
36047008800,2225,1095,1039,335,704,47321,36,047,008800
36047009001,1436,439,458,105,353,28203,36,047,009001
36047009002,1334,301,426,90,336,31413,36,047,009002
36047009201,2013,391,567,192,375,30102,36,047,009201
36047117000,2058,494,731,83,648,25129,36,047,117000
36047117201,2190,745,734,364,370,39471,36,047,117201
36047117202,3991,1292,1485,604,881,33026,36,047,117202
36047117400,3914,1889,1285,219,1066,28712,36,047,117400
36047117601,3345,963,1050,307,743,35068,36,047,117601
36047117602,2693,1375,910,346,564,39795,36,047,117602
36047117800,1686,564,523,181,342,22014,36,047,117800
36047118000,0,0,0,0,0,-666666666,36,047,118000
36047118201,2883,1195,933,242,691,41719,36,047,118201
36047118202,3477,1783,1001,369,632,38077,36,047,118202
36047118400,4817,1769,1503,452,1051,31843,36,047,118400
36047118600,2943,764,749,399,350,31752,36,047,118600
36047118800,4758,1175,1428,387,1041,30615,36,047,118800
36047119000,2227,491,786,207,579,31554,36,047,119000
36047119200,3043,734,1097,315,782,32006,36,047,119200
36047119400,5362,844,1394,355,1039,40783,36,047,119400
36047119600,4832,975,1941,399,1542,36131,36,047,119600
36047119800,3175,742,1064,252,812,37329,36,047,119800
36047120000,2652,288,825,239,586,31296,36,047,120000
36047120200,2078,187,584,244,340,26250,36,047,120200
36047120801,5096,124,1422,650,772,39503,36,047,120801
36047120802,4138,260,1667,35,1632,31724,36,047,120802
36047120803,2203,809,606,199,407,47311,36,047,120803
36047121000,4203,1249,1629,0,1629,31500,36,047,121000
36047121400,4342,779,1639,0,1639,22585,36,047,121400
36047122000,6091,243,2181,351,1830,38203,36,047,122000
36047123700,7133,6583,1171,259,912,23077,36,047,123700
36047150200,2608,2268,964,553,411,71007,36,047,150200
36047152200,3629,1867,1174,792,382,60723,36,047,152200
36047990100,0,0,0,0,0,-666666666,36,047,990100
36049950101,2354,2343,909,771,138,37731,36,049,950101
36049950200,4204,4147,1640,1302,338,35096,36,049,950200
36049950301,3667,3545,1465,974,491,30082,36,049,950301
36049950302,4218,3884,1495,1172,323,38950,36,049,950302
36049950401,2430,2401,993,932,61,33289,36,049,950401
36049950500,2397,2294,987,755,232,36821,36,049,950500
36049950601,1196,1146,497,442,55,27024,36,049,950601
36049950700,5135,4934,2002,1686,316,32260,36,049,950700
36049950800,855,851,410,373,37,31250,36,049,950800
36051030100,4119,3699,1702,1379,323,37543,36,051,030100
36051030201,5172,4642,2040,1156,884,14396,36,051,030201
36051030203,2438,2206,1067,647,420,49950,36,051,030203
36051030204,3618,3461,1706,1280,426,42226,36,051,030204
36051030300,3271,3173,1352,912,440,32348,36,051,030300
36051030400,3289,3017,1318,697,621,18409,36,051,030400
36051030500,2912,2595,0,0,0,3654,36,051,030500
36061016500,6674,5425,3176,1392,1784,115385,36,061,016500
36061016600,6002,2824,2796,165,2631,47231,36,061,016600
36061016700,6058,5236,2969,1168,1801,130889,36,061,016700
36061016800,5189,1721,1774,127,1647,35571,36,061,016800
36061016900,8272,6895,3949,1126,2823,93327,36,061,016900
36061017000,8100,2811,3448,278,3170,35075,36,061,017000
36061017100,9168,8363,4275,1908,2367,74605,36,061,017100
36061017200,5120,1435,2091,73,2018,27784,36,061,017200
36061017300,7868,6164,4350,979,3371,105282,36,061,017300
36061017401,4531,1010,2041,321,1720,32707,36,061,017401
36061017402,2661,933,1118,137,981,41086,36,061,017402
36061017500,10750,8183,4769,2248,2521,79415,36,061,017500
36061017700,9437,7297,4414,1842,2572,60772,36,061,017700
36061017800,4278,1574,1908,147,1761,47667,36,061,017800
36061017900,8916,7165,4205,1430,2775,83513,36,061,017900
36061018000,6324,1968,2994,109,2885,24028,36,061,018000
36061018100,8859,5920,4264,1375,2889,70515,36,061,018100
36061018200,7434,967,2993,60,2933,40395,36,061,018200
36061018300,7963,6483,3644,1237,2407,84773,36,061,018300
36061018400,7387,1624,3277,331,2946,35547,36,061,018400
36061018500,4756,3297,2605,1008,1597,81643,36,061,018500
36061018600,6282,1334,1953,51,1902,26365,36,061,018600
36061018700,9524,7007,3672,1252,2420,68182,36,061,018700
36061018800,4888,1062,2154,90,2064,40789,36,061,018800
36061018900,11014,4465,4584,535,4049,33037,36,061,018900
36061019000,3790,712,1688,664,1024,59476,36,061,019000
36061019100,9124,6437,4458,1956,2502,94533,36,061,019100
36061019200,4259,632,1513,16,1497,18617,36,061,019200
36061019300,9896,3501,3917,664,3253,41305,36,061,019300
36061019400,5982,1255,2645,167,2478,41422,36,061,019400
36061019500,7226,4123,3254,1114,2140,47358,36,061,019500
36061019600,4297,672,1752,0,1752,37688,36,061,019600
36061019701,655,256,372,0,372,31157,36,061,019701
36061019702,2720,891,1105,291,814,51729,36,061,019702
36061019800,2433,628,919,413,506,71813,36,061,019800
36061019900,8344,5931,2953,1052,1901,51116,36,061,019900
36061020000,3324,904,1494,309,1185,59009,36,061,020000
36061020101,1759,1120,237,57,180,10063,36,061,020101
36061020102,4044,1300,1574,325,1249,53697,36,061,020102
36061020300,3834,2130,453,49,404,7107,36,061,020300
36061020500,5287,3944,1199,198,1001,17069,36,061,020500
36061020600,3405,937,1567,166,1401,45840,36,061,020600
36061020701,2825,1555,1143,25,1118,41932,36,061,020701
36061020800,5686,1309,2263,379,1884,61603,36,061,020800
36061020901,3498,503,1368,77,1291,33819,36,061,020901
36061021000,6943,608,3418,293,3125,45444,36,061,021000
36081012100,1935,1517,816,311,505,61827,36,081,012100
36081012200,2933,843,673,380,293,33934,36,081,012200
36081012301,2917,2198,1153,472,681,60735,36,081,012301
36081012400,3101,769,858,314,544,30750,36,081,012400
36081012500,1587,982,664,91,573,57308,36,081,012500
36081012601,2749,1063,724,328,396,31909,36,081,012601
36081012602,2715,1175,754,384,370,27315,36,081,012602
36081012800,2187,1297,737,372,365,42303,36,081,012800
36081013000,1787,1112,614,248,366,36190,36,081,013000
36081013200,2112,1347,654,286,368,49375,36,081,013200
36081013400,4253,2669,2133,691,1442,50712,36,081,013400
36081013500,1236,1159,483,286,197,57250,36,081,013500
36081013600,1866,1290,781,313,468,52284,36,081,013600
36081013700,1785,1434,778,182,596,60693,36,081,013700
36081013800,3724,1697,1442,647,795,49348,36,081,013800
36081014000,3716,2375,1157,551,606,54042,36,081,014000
36081014100,1690,1107,684,94,590,41364,36,081,014100
36081014201,4541,961,1340,469,871,27367,36,081,014201
36081014202,2721,606,647,251,396,27650,36,081,014202
36081014300,3456,2228,1534,186,1348,41985,36,081,014300
36081014400,1971,537,538,197,341,26576,36,081,014400
36081014500,2331,1887,886,235,651,49275,36,081,014500
36081014700,2712,1964,1286,220,1066,46415,36,081,014700
36081014800,1615,167,450,306,144,27917,36,081,014800
36081014900,1822,1423,812,33,779,42208,36,081,014900
36081015000,2562,103,615,398,217,34542,36,081,015000
36081015100,2582,1774,1185,261,924,50367,36,081,015100
36081015200,2906,306,746,393,353,32823,36,081,015200
36081015300,1922,1205,807,108,699,44013,36,081,015300
36081015400,1916,160,531,245,286,30161,36,081,015400
36081015500,2269,1231,801,185,616,50746,36,081,015500
36081015600,2976,140,738,471,267,36297,36,081,015600
36081015700,1278,597,588,16,572,44010,36,081,015700
36081015801,3991,182,1034,774,260,35733,36,081,015801
36081015802,4629,185,1198,738,460,37463,36,081,015802
36081015900,3359,2223,1589,165,1424,44135,36,081,015900
36081016100,2301,1315,760,153,607,37939,36,081,016100
36081016300,3422,1180,1665,91,1574,26006,36,081,016300
36081016400,4082,140,948,767,181,41380,36,081,016400
36081016600,3840,357,1043,641,402,35900,36,081,016600
36081016800,3405,440,861,618,243,38622,36,081,016800
36081016900,5573,3758,2557,970,1587,50792,36,081,016900
36081017000,2751,109,701,566,135,30838,36,081,017000
36081017101,0,0,0,0,0,-666666666,36,081,017101
36081017102,22,0,0,0,0,-666666666,36,081,017102
36081017200,1845,130,590,483,107,37429,36,081,017200
36085014100,2564,1110,1032,540,492,36721,36,085,014100
36085014604,7041,6024,2452,2051,401,66043,36,085,014604
36085014605,3819,3621,1326,1087,239,53426,36,085,014605
36085014606,5734,5547,2062,1822,240,59691,36,085,014606
36085014607,4725,4155,1646,1329,317,62054,36,085,014607
36085014608,3264,3061,1169,1085,84,49013,36,085,014608
36085014700,3188,2844,1396,1036,360,62393,36,085,014700
36085015100,5602,4860,1815,1517,298,60338,36,085,015100
36085015400,0,0,0,0,0,-666666666,36,085,015400
36085015601,6075,5204,2259,1734,525,59375,36,085,015601
36085015602,3325,3252,1111,1020,91,56607,36,085,015602
36085015603,4636,4216,1634,1300,334,56728,36,085,015603
36085016901,3679,2897,1090,808,282,50684,36,085,016901
36085017005,4913,4122,1688,1385,303,53529,36,085,017005
36085017007,6229,4932,1866,1682,184,49659,36,085,017007
36085017009,4710,4448,1588,1199,389,69975,36,085,017009
36085017011,4514,4381,1717,1400,317,60000,36,085,017011
36085017012,4020,3636,1579,1259,320,62542,36,085,017012
36085017013,4508,3709,1506,1321,185,42740,36,085,017013
36085017014,4473,3749,1636,1255,381,49167,36,085,017014
36085017015,2490,2490,952,820,132,49551,36,085,017015
36085017016,4405,3780,1442,1332,110,54341,36,085,017016
36085017300,2329,1094,968,384,584,40689,36,085,017300
36085017600,4897,4571,1556,1378,178,75536,36,085,017600
36085017701,3456,2750,1305,1172,133,100213,36,085,017701
36085017702,2562,2470,944,798,146,42249,36,085,017702
36085018100,3146,2728,1262,911,351,63608,36,085,018100
36085018701,1791,1149,628,462,166,59750,36,085,018701
36085018703,4387,1790,1273,872,401,49250,36,085,018703
36085018704,3459,2368,1176,842,334,50060,36,085,018704
36085018901,4562,3271,1599,1212,387,46556,36,085,018901
36085018902,5742,4167,1700,1400,300,52913,36,085,018902
36085019700,1756,1487,702,595,107,51083,36,085,019700
36085019800,7075,6507,2376,1721,655,49641,36,085,019800
36085020100,3655,2553,1278,790,488,63814,36,085,020100
36085020701,3164,773,954,540,414,30156,36,085,020701
36085020702,2133,1181,876,357,519,35147,36,085,020702
36085020803,7595,7196,2488,2203,285,60130,36,085,020803
36085020804,6228,5498,2094,1756,338,52691,36,085,020804
36085020805,6337,5916,2343,2123,220,57250,36,085,020805
36085020806,2097,2037,853,624,229,69202,36,085,020806
36085021300,4866,2708,1491,811,680,39303,36,085,021300
36085022300,2739,1189,941,700,241,34769,36,085,022300
36085022601,6858,6550,2383,1931,452,70550,36,085,022601
36085022602,1425,1382,676,308,368,28116,36,085,022602
36103200904,1952,1870,766,612,154,69246,36,103,200904
36103200905,1739,1703,773,724,49,85083,36,103,200905
36103200906,2399,1854,1101,918,183,-666666666,36,103,200906
36103201005,2228,1458,739,595,144,37079,36,103,201005
36103201006,634,600,305,274,31,57361,36,103,201006
36103201007,1601,1475,551,457,94,50769,36,103,201007
36103201008,1962,1869,760,647,113,41750,36,103,201008
36103201009,4925,4030,1737,1189,548,41418,36,103,201009
36103201010,2321,2015,1052,931,121,51658,36,103,201010
36103201200,602,412,0,0,0,-666666666,36,103,201200
36103990100,0,0,0,0,0,-666666666,36,103,990100
36105950100,3427,3109,1472,1208,264,45679,36,105,950100
36105950201,2607,1867,1121,912,209,30191,36,105,950201
36105950202,1073,1032,603,440,163,-666666666,36,105,950202
36105950300,1257,1191,522,473,49,38750,36,105,950300
36105950400,2922,2687,1201,941,260,41250,36,105,950400
36105950500,3526,3126,1194,752,442,37188,36,105,950500
36105950600,1663,1470,607,510,97,39639,36,105,950600
36105950701,2969,1509,1004,259,745,21563,36,105,950701
36105950702,1249,816,479,236,243,29966,36,105,950702
36105950801,2836,1810,842,560,282,32981,36,105,950801
36105950802,1881,1695,817,615,202,39599,36,105,950802
36105950900,2929,2367,1024,647,377,19146,36,105,950900
36105951000,2100,1273,1016,419,597,31323,36,105,951000
36105951100,3236,1868,769,545,224,33214,36,105,951100
36105951201,4308,3606,1399,1095,304,44395,36,105,951201
36105951202,3325,2952,1035,664,371,34875,36,105,951202
36105951301,1990,1921,677,580,97,28537,36,105,951301
36105951302,1832,1534,800,664,136,50558,36,105,951302
36105951500,2739,2192,1008,481,527,26123,36,105,951500
36105951600,3411,2041,1261,859,402,37588,36,105,951600
36105951701,3468,2771,1374,1135,239,44427,36,105,951701
36105951702,914,840,403,380,23,51713,36,105,951702
36105951801,3003,1506,1082,433,649,29596,36,105,951801
36105951802,2364,895,928,287,641,24957,36,105,951802
36105951900,2053,1952,806,508,298,38609,36,105,951900
36105952000,2082,1924,896,683,213,39840,36,105,952000
36105952100,2574,2096,1142,866,276,41570,36,105,952100
36105952200,1488,1305,663,545,118,44851,36,105,952200
36105952300,1571,1411,732,582,150,31419,36,105,952300
36105952400,2356,2248,1108,978,130,42005,36,105,952400
36105952500,2176,1972,777,723,54,43500,36,105,952500
36107020101,2421,2389,972,865,107,35599,36,107,020101
36107020102,3735,3535,1486,1261,225,39047,36,107,020102
36107020200,4995,4805,2264,1637,627,34362,36,107,020200
36061021100,10709,4001,4442,1025,3417,47147,36,061,021100
36061021200,4160,491,2351,85,2266,67031,36,061,021200
36061021303,6307,1239,2333,87,2246,31683,36,061,021303
36061021400,3143,353,2048,0,2048,55855,36,061,021400
36061021500,4277,521,1760,40,1720,39422,36,061,021500
36061021600,9267,2133,3449,456,2993,44742,36,061,021600
36061021703,11,11,6,6,0,-666666666,36,061,021703
36061021800,6198,1848,2801,415,2386,58607,36,061,021800
36061021900,6121,885,2063,23,2040,23380,36,061,021900
36061022000,6503,1714,2715,357,2358,44874,36,061,022000
36061022102,2690,801,1139,470,669,54578,36,061,022102
36061022200,3479,1181,1458,282,1176,46845,36,061,022200
36061022301,8102,3138,2661,220,2441,32123,36,061,022301
36061022302,3067,613,1392,37,1355,32128,36,061,022302
36061022400,7363,869,2688,166,2522,45127,36,061,022400
36061022500,10897,3037,3691,872,2819,33657,36,061,022500
36061022600,4704,1066,1936,284,1652,47869,36,061,022600
36061022700,5321,1560,2141,473,1668,40922,36,061,022700
36061022800,6106,954,2802,577,2225,47661,36,061,022800
36061022900,9075,2792,3117,340,2777,25687,36,061,022900
36061023000,8589,968,3793,230,3563,36615,36,061,023000
36061023100,6750,1418,2475,375,2100,36051,36,061,023100
36061023200,9518,1353,3246,55,3191,28516,36,061,023200
36061023300,6974,2250,2541,396,2145,38462,36,061,023300
36061023400,4945,1378,2483,225,2258,41639,36,061,023400
36061023501,6751,2155,2612,352,2260,36141,36,061,023501
36061023502,1845,255,779,55,724,31096,36,061,023502
36061023600,7679,498,3389,856,2533,34913,36,061,023600
36061023700,6439,1669,2586,212,2374,33727,36,061,023700
36061023802,6219,2966,1907,81,1826,76768,36,061,023802
36061023803,3021,1524,1517,800,717,84514,36,061,023803
36061023804,3530,1459,1623,412,1211,84444,36,061,023804
36061023900,3122,714,1206,140,1066,31484,36,061,023900
36061024000,1860,454,0,0,0,12641,36,061,024000
36061024100,8177,2062,3361,1019,2342,33287,36,061,024100
36061024200,5152,533,1752,0,1752,30697,36,061,024200
36061024301,5192,917,1642,61,1581,37520,36,061,024301
36061024302,7225,607,2668,26,2642,18284,36,061,024302
36061024500,14089,3521,5497,164,5333,30020,36,061,024500
36061024700,7170,1951,2696,426,2270,33708,36,061,024700
36061024900,957,288,439,41,398,32454,36,061,024900
36061025100,2779,675,847,8,839,26925,36,061,025100
36061025300,12515,4075,4097,92,4005,27310,36,061,025300
36061025500,6173,2663,2198,191,2007,41824,36,061,025500
36061025700,4738,1649,1969,476,1493,49056,36,061,025700
36061025900,3642,1180,1710,692,1018,50278,36,061,025900
36081017400,2277,249,652,538,114,41149,36,081,017400
36081017600,2011,184,579,395,184,27269,36,081,017600
36081017800,2214,200,581,464,117,37566,36,081,017800
36081017901,1139,550,429,44,385,36364,36,081,017901
36081017902,11,6,5,5,0,-666666666,36,081,017902
36081018000,1458,330,360,242,118,48750,36,081,018000
36081018101,3589,1588,1721,110,1611,41741,36,081,018101
36081018102,3147,1844,1685,250,1435,62500,36,081,018102
36081018200,2422,114,671,531,140,31835,36,081,018200
36081018300,6126,4043,2586,803,1783,56008,36,081,018300
36081018401,1999,16,645,361,284,40160,36,081,018401
36081018402,2399,135,613,478,135,35833,36,081,018402
36081018501,3377,2127,1616,667,949,50068,36,081,018501
36081018502,3061,1840,1505,332,1173,52054,36,081,018502
36081018600,1847,46,545,403,142,31968,36,081,018600
36081018700,2922,1436,985,431,554,43363,36,081,018700
36081018800,1364,235,402,254,148,30735,36,081,018800
36081018900,3098,1155,1198,326,872,39787,36,081,018900
36081019000,2461,125,749,556,193,36902,36,081,019000
36081019200,1928,193,611,411,200,42500,36,081,019200
36081019400,2934,74,798,599,199,34221,36,081,019400
36081019600,3170,55,762,332,430,33696,36,081,019600
36081019800,2820,45,822,362,460,31106,36,081,019800
36081019901,546,146,98,23,75,40417,36,081,019901
36081019902,0,0,0,0,0,-666666666,36,081,019902
36081019903,0,0,0,0,0,-666666666,36,081,019903
36081020200,1688,35,396,339,57,40426,36,081,020200
36081020400,2133,48,698,214,484,30458,36,081,020400
36081020500,1283,779,390,174,216,27964,36,081,020500
36081020600,1721,224,423,163,260,26946,36,081,020600
36081020800,3188,925,782,313,469,36328,36,081,020800
36081021200,2496,510,675,167,508,33585,36,081,021200
36081021400,6723,628,2167,646,1521,25962,36,081,021400
36081021601,2588,1603,1307,633,674,73725,36,081,021601
36081021602,1831,792,547,207,340,30650,36,081,021602
36081021603,0,0,0,0,0,-666666666,36,081,021603
36081021900,0,0,0,0,0,-666666666,36,081,021900
36081022001,5901,2583,2670,475,2195,59475,36,081,022001
36081022002,7421,2875,2671,1164,1507,47727,36,081,022002
36081022900,0,0,0,0,0,-666666666,36,081,022900
36081023000,2018,725,552,378,174,35584,36,081,023000
36081023200,5487,1329,2059,744,1315,52390,36,081,023200
36081023501,4786,2001,1637,145,1492,34065,36,081,023501
36081023502,2804,1359,1078,48,1030,30852,36,081,023502
36081023600,3018,481,807,150,657,31094,36,081,023600
36081023800,4621,133,1493,94,1399,26323,36,081,023800
36085022801,24,18,10,0,10,-666666666,36,085,022801
36085022802,0,0,0,0,0,-666666666,36,085,022802
36085023100,5041,2383,1435,832,603,31216,36,085,023100
36085023900,3809,2080,1008,732,276,36674,36,085,023900
36085024401,5917,5509,1902,1484,418,60802,36,085,024401
36085024402,4970,4771,1714,1375,339,64070,36,085,024402
36085024700,3163,1273,951,541,410,40611,36,085,024700
36085024800,4907,4295,1667,1310,357,48438,36,085,024800
36085025100,5789,4697,2107,1949,158,57967,36,085,025100
36085027301,3697,2528,1446,1160,286,49341,36,085,027301
36085027302,4225,3142,1253,883,370,33442,36,085,027302
36085027702,6474,5082,2888,1900,988,57246,36,085,027702
36085027704,4606,3300,1583,1160,423,41043,36,085,027704
36085027705,6117,3951,2017,1508,509,38892,36,085,027705
36085027706,3744,2541,1174,927,247,63549,36,085,027706
36085027900,2192,1821,609,501,108,57500,36,085,027900
36085029102,3110,1892,1001,907,94,50179,36,085,029102
36085029104,7216,5200,2454,1936,518,41749,36,085,029104
36085029105,4435,3410,1564,1098,466,46082,36,085,029105
36085029106,3511,2884,1043,799,244,52439,36,085,029106
36085030301,5151,3287,1918,1287,631,44800,36,085,030301
36085030302,6569,3153,2069,1511,558,49393,36,085,030302
36085031901,3293,1001,1174,366,808,27332,36,085,031901
36085031902,4953,1459,1554,845,709,40391,36,085,031902
36085032300,1200,464,445,373,72,58500,36,085,032300
36085990100,0,0,0,0,0,-666666666,36,085,990100
36087010101,6034,4462,1963,1764,199,43958,36,087,010101
36087010102,4938,3816,1718,1529,189,50444,36,087,010102
36087010200,4390,3300,1608,1335,273,47106,36,087,010200
36087010501,4297,2881,1442,1302,140,57800,36,087,010501
36087010503,2921,1592,875,812,63,63179,36,087,010503
36087010504,7390,3835,2867,1873,994,49104,36,087,010504
36087010601,3984,1560,1218,1027,191,47290,36,087,010601
36087010602,6430,3249,2233,981,1252,30433,36,087,010602
36087010701,4584,1799,1328,782,546,29538,36,087,010701
36087010702,3872,1160,1127,389,738,30883,36,087,010702
36087010703,3620,1610,1153,376,777,31408,36,087,010703
36087010801,4361,2963,1379,1352,27,71341,36,087,010801
36087010802,5517,4173,1806,1712,94,61513,36,087,010802
36087010803,4896,3509,1744,1409,335,54071,36,087,010803
36087010804,4087,3119,1340,1215,125,75179,36,087,010804
36087010901,4687,3899,1558,1407,151,65533,36,087,010901
36087010902,3906,2504,1362,1037,325,48446,36,087,010902
36087011000,2322,1817,783,712,71,77054,36,087,011000
36087011101,5674,3790,2015,1786,229,46481,36,087,011101
36107020401,4530,4367,1899,1628,271,41422,36,107,020401
36107020402,4045,3834,1624,1488,136,50453,36,107,020402
36107020500,3850,3649,1933,896,1037,33420,36,107,020500
36107020600,7204,7035,3012,2428,584,32551,36,107,020600
36107020701,2915,2726,1212,919,293,30395,36,107,020701
36107020702,4231,4140,1653,1418,235,30454,36,107,020702
36107020703,4178,3826,1759,982,777,30449,36,107,020703
36109000100,1575,1169,1109,62,1047,34046,36,109,000100
36109000201,3844,1771,1396,0,1396,9985,36,109,000201
36109000202,2065,1158,1052,153,899,10454,36,109,000202
36109000300,2922,1983,248,27,221,3353,36,109,000300
36109000400,4273,2810,353,90,263,3442,36,109,000400
36109000500,4366,2694,1959,868,1091,42250,36,109,000500
36109000600,4644,3618,1731,808,923,25808,36,109,000600
36109000700,3750,2921,1764,636,1128,25412,36,109,000700
36109000800,2427,1847,1238,439,799,28632,36,109,000800
36109000900,4173,3412,1917,1173,744,42909,36,109,000900
36109001000,4698,3241,2203,917,1286,31018,36,109,001000
36109001100,5598,4695,2126,955,1171,12448,36,109,001100
36109001200,3062,2372,9,9,0,2664,36,109,001200
36109001301,3253,1935,1788,582,1206,30714,36,109,001301
36109001302,3101,1959,1426,790,636,36667,36,109,001302
36109001400,3509,3137,1609,935,674,36779,36,109,001400
36109001500,5745,4413,2435,1404,1031,43340,36,109,001500
36109001600,4381,4102,1993,1439,554,39545,36,109,001600
36109001700,4080,3885,1702,1344,358,34453,36,109,001700
36109001800,5146,4877,2340,1758,582,40016,36,109,001800
36109001901,2948,2710,1284,690,594,39481,36,109,001901
36109001902,3111,2669,1280,1059,221,37443,36,109,001902
36109002000,4557,4120,1669,1151,518,30867,36,109,002000
36109002100,4471,4253,1970,1379,591,37353,36,109,002100
36109002200,4697,4379,1838,1299,539,35787,36,109,002200
36109002300,5841,5238,2378,2058,320,44009,36,109,002300
36111950100,4705,4180,1922,1649,273,45455,36,111,950100
36111950200,3790,3384,1727,839,888,38750,36,111,950200
36111950300,4268,3634,1853,1000,853,30394,36,111,950300
36107020300,6327,6080,2829,2549,280,44597,36,107,020300
36111950400,4672,4438,1924,1523,401,36234,36,111,950400
36111950500,3059,2724,1532,973,559,27015,36,111,950500
36111950600,2722,2542,1408,1117,291,35122,36,111,950600
36111950900,1229,1094,550,431,119,44464,36,111,950900
36111951000,4297,3844,1683,1523,160,31144,36,111,951000
36111951100,2034,1973,971,920,51,31359,36,111,951100
36111951200,4021,3404,1644,1519,125,51230,36,111,951200
36111951300,4115,3537,1627,985,642,36607,36,111,951300
36111951400,3608,3025,1723,792,931,32459,36,111,951400
36061026100,11981,2500,3634,74,3560,27550,36,061,026100
36061026300,9116,2747,2992,42,2950,29401,36,061,026300
36061026500,7618,4076,2764,721,2043,48596,36,061,026500
36061026700,1966,1307,531,0,531,31058,36,061,026700
36061026900,9586,1846,2791,78,2713,26139,36,061,026900
36061027100,8916,4007,2920,330,2590,37485,36,061,027100
36061027300,7111,5258,3149,832,2317,60806,36,061,027300
36061027500,3079,2501,1460,832,628,66190,36,061,027500
36061027700,6659,1583,2153,0,2153,22879,36,061,027700
36061027900,11988,4188,4181,462,3719,29213,36,061,027900
36061028100,3283,2353,1515,411,1104,74345,36,061,028100
36061028300,8026,2059,2983,634,2349,33827,36,061,028300
36061028500,8408,1498,2552,0,2552,29652,36,061,028500
36061028700,4191,1939,1629,49,1580,34813,36,061,028700
36061029100,12148,2576,4171,143,4028,29598,36,061,029100
36061029300,9559,2099,3041,14,3027,29825,36,061,029300
36061029500,7905,3850,3266,265,3001,44365,36,061,029500
36061029700,21,4,0,0,0,-666666666,36,061,029700
36061029900,3507,1001,1522,21,1501,23580,36,061,029900
36061030300,4298,2067,1737,124,1613,53396,36,061,030300
36061030700,4033,2742,1786,781,1005,69349,36,061,030700
36061030900,11190,2627,3913,158,3755,23348,36,061,030900
36061031100,0,0,0,0,0,-666666666,36,061,031100
36061031703,6086,4670,2499,215,2284,156028,36,061,031703
36061031704,10083,7789,4934,1627,3307,125405,36,061,031704
36061031900,0,0,0,0,0,-666666666,36,061,031900
36063020100,3519,2723,1437,1228,209,37383,36,063,020100
36063020200,2622,429,1196,229,967,10388,36,063,020200
36063020300,2346,1801,1030,710,320,30292,36,063,020300
36063020400,1553,708,637,375,262,20865,36,063,020400
36063020500,1901,1295,910,364,546,27879,36,063,020500
36063020600,1294,425,604,256,348,19961,36,063,020600
36063020700,2747,1671,1113,794,319,25690,36,063,020700
36063020900,2105,902,1192,291,901,16604,36,063,020900
36063021000,2811,2199,1417,800,617,30842,36,063,021000
36063021100,1280,692,740,133,607,25275,36,063,021100
36063021200,2188,1367,1097,457,640,25781,36,063,021200
36063021300,1874,1238,1020,485,535,25056,36,063,021300
36063021400,2237,1814,1064,667,397,28633,36,063,021400
36063021700,3667,2249,1433,661,772,28406,36,063,021700
36063022000,3227,2598,1385,937,448,31058,36,063,022000
36063022100,2122,1806,991,872,119,32823,36,063,022100
36063022200,3674,3351,1819,1465,354,44069,36,063,022200
36063022300,2401,2059,998,760,238,38790,36,063,022300
36063022401,1898,1684,885,722,163,36786,36,063,022401
36063022500,2512,2305,1362,885,477,28889,36,063,022500
36081024300,4873,2402,1910,1240,670,34621,36,081,024300
36081024500,4372,2451,2024,908,1116,40547,36,081,024500
36081024600,0,0,0,0,0,-666666666,36,081,024600
36081024700,1394,259,469,119,350,31265,36,081,024700
36081024900,4996,1497,1839,447,1392,33412,36,081,024900
36081025100,5552,2743,2423,1219,1204,47717,36,081,025100
36081025301,3945,2332,1792,161,1631,43905,36,081,025301
36081025302,3202,1652,1199,203,996,34105,36,081,025302
36081025401,4257,75,937,388,549,38750,36,081,025401
36081025402,5770,445,1973,408,1565,24172,36,081,025402
36081025500,1555,777,480,147,333,39417,36,081,025500
36081025700,1592,661,573,328,245,41168,36,081,025700
36081025800,2179,23,497,345,152,33247,36,081,025800
36081025900,3272,1491,1219,327,892,34384,36,081,025900
36081026000,2664,57,702,157,545,33618,36,081,026000
36081026100,6549,2336,2246,193,2053,31891,36,081,026100
36081026200,1365,33,385,252,133,30439,36,081,026200
36081026300,5566,1693,2060,526,1534,32380,36,081,026300
36081026400,2418,23,837,337,500,34612,36,081,026400
36081026501,2562,708,1032,187,845,34861,36,081,026501
36081026502,1135,350,342,45,297,31049,36,081,026502
36081026600,1719,57,720,226,494,25116,36,081,026600
36081026700,4836,624,2182,319,1863,31520,36,081,026700
36081026901,5105,928,1577,239,1338,28903,36,081,026901
36081026902,3452,506,1161,364,797,26577,36,081,026902
36081027000,2002,425,407,316,91,40000,36,081,027000
36081027101,5290,593,2002,685,1317,31573,36,081,027101
36081027102,3340,947,1029,77,952,27292,36,081,027102
36081027200,2050,20,595,393,202,29381,36,081,027200
36081027301,2634,1521,762,67,695,25616,36,081,027301
36081027302,4600,2431,1462,228,1234,26859,36,081,027302
36081027400,1688,45,621,551,70,29797,36,081,027400
36081027500,6325,2870,2147,957,1190,32415,36,081,027500
36081027600,1455,58,413,339,74,44844,36,081,027600
36081027701,3651,931,1258,294,964,39832,36,081,027701
36081027702,4190,1896,1604,521,1083,40236,36,081,027702
36081027800,2338,179,890,254,636,32500,36,081,027800
36081024000,6950,544,2259,177,2082,27412,36,081,024000
36081027900,6209,3441,2333,777,1556,31599,36,081,027900
36081028000,1589,49,484,266,218,34605,36,081,028000
36081028100,5393,3839,2293,981,1312,36027,36,081,028100
36081028200,1935,37,524,286,238,35714,36,081,028200
36081028300,7284,3959,3155,902,2253,47283,36,081,028300
36081028400,4054,131,1241,747,494,37440,36,081,028400
36081028500,4800,2932,1989,899,1090,49347,36,081,028500
36081028700,6462,3295,2915,1049,1866,52565,36,081,028700
36087011102,6106,3993,2360,1609,751,35069,36,087,011102
36087011200,6346,4603,2321,2264,57,61085,36,087,011200
36087011302,6142,3963,2140,1991,149,54653,36,087,011302
36087011303,5187,3930,2219,1377,842,62829,36,087,011303
36087011304,4613,1679,1424,597,827,22433,36,087,011304
36087011305,4517,2098,1472,433,1039,45180,36,087,011305
36087011401,4288,2972,1304,1241,63,65625,36,087,011401
36087011403,5594,4808,1953,1730,223,75136,36,087,011403
36087011404,3630,2444,1598,1487,111,65216,36,087,011404
36087011405,4480,2102,1198,922,276,43179,36,087,011405
36087011505,3532,3339,707,81,626,17278,36,087,011505
36087011506,5504,5373,1000,194,806,11495,36,087,011506
36087011507,3347,3093,818,784,34,44458,36,087,011507
36087011508,4134,3975,1111,855,256,66364,36,087,011508
36087011509,3512,1917,827,779,48,37991,36,087,011509
36087011510,4932,3431,1083,887,196,41373,36,087,011510
36087011511,3459,1626,755,503,252,32122,36,087,011511
36087011512,3840,633,943,870,73,35802,36,087,011512
36087011601,3130,2739,1025,899,126,54631,36,087,011601
36087011602,5271,4543,1815,1053,762,61563,36,087,011602
36087011603,5803,4443,1758,1379,379,59158,36,087,011603
36087011700,3114,2702,1256,1078,178,56196,36,087,011700
36087011800,1031,373,297,171,126,31761,36,087,011800
36087011901,3641,2424,1214,837,377,37994,36,087,011901
36087011902,3660,2325,1503,637,866,54798,36,087,011902
36087012000,3644,3120,1875,1661,214,56535,36,087,012000
36087012107,4586,4574,799,377,422,18492,36,087,012107
36087012108,6214,6113,1204,108,1096,16348,36,087,012108
36087012109,2876,2728,491,80,411,16109,36,087,012109
36087012110,2840,2719,526,110,416,18558,36,087,012110
36087012111,3399,3368,562,243,319,21063,36,087,012111
36087012112,3237,3126,584,212,372,23935,36,087,012112
36087012113,3384,3377,632,318,314,24436,36,087,012113
36087012114,2441,2268,501,237,264,29643,36,087,012114
36087012115,1842,739,325,240,85,30750,36,087,012115
36087012116,3649,3522,545,223,322,20887,36,087,012116
36087012203,3142,2865,954,257,697,31208,36,087,012203
36087012204,4189,4008,670,313,357,27594,36,087,012204
36087012205,2687,417,855,61,794,21979,36,087,012205
36087012206,3377,322,1174,475,699,29835,36,087,012206
36087012301,3060,1983,671,157,514,21397,36,087,012301
36087012302,3027,817,845,159,686,19246,36,087,012302
36087012401,6234,1806,2417,416,2001,30632,36,087,012401
36087012403,2298,741,613,232,381,24953,36,087,012403
36087012404,2087,607,616,265,351,28497,36,087,012404
36111951600,2201,2012,990,815,175,41736,36,111,951600
36111951700,4919,3395,1952,719,1233,30914,36,111,951700
36111951800,1534,1038,674,304,370,30565,36,111,951800
36111951900,2678,1864,876,578,298,35657,36,111,951900
36111952000,2836,1470,985,455,530,22949,36,111,952000
36111952100,3959,1967,1293,461,832,30086,36,111,952100
36111952200,3414,2748,1337,983,354,42593,36,111,952200
36111952300,1363,883,689,212,477,41633,36,111,952300
36111952400,2251,1758,1146,380,766,26396,36,111,952400
36111952500,3237,2702,1353,1071,282,43125,36,111,952500
36111952600,5523,5181,2389,1976,413,42326,36,111,952600
36111952700,2783,2463,1170,784,386,31391,36,111,952700
36111952800,3041,2276,1133,873,260,30947,36,111,952800
36111952901,2846,2448,1090,878,212,46087,36,111,952901
36111952902,2660,2022,1331,1166,165,42597,36,111,952902
36111953000,1812,1678,770,603,167,37209,36,111,953000
36111953300,4497,4168,1595,1359,236,57933,36,111,953300
36111953400,4483,3773,2113,939,1174,25000,36,111,953400
36111953500,5137,3902,1026,389,637,4520,36,111,953500
36111953600,5790,4803,2184,1084,1100,43098,36,111,953600
36111953700,4777,4092,1925,1533,392,44883,36,111,953700
36111953800,3671,3459,1658,1046,612,50526,36,111,953800
36111953900,4952,4415,1854,1483,371,52933,36,111,953900
36111954000,4643,3856,2004,1620,384,41187,36,111,954000
36111954100,5586,4673,2048,1413,635,42883,36,111,954100
36111954200,5617,4798,2187,1557,630,40459,36,111,954200
36111954401,4853,3576,884,726,158,37750,36,111,954401
36111954402,4851,4386,1711,1491,220,42102,36,111,954402
36111954500,4428,2940,1172,907,265,39493,36,111,954500
36111954600,1431,990,608,557,51,34583,36,111,954600
36111954700,1550,1383,515,421,94,41314,36,111,954700
36111954800,5315,3372,2114,889,1225,25890,36,111,954800
36111954900,1623,1474,616,469,147,42614,36,111,954900
36111955001,2119,1937,922,766,156,45026,36,111,955001
36111955002,3253,2543,1155,860,295,24271,36,111,955002
36111955300,2275,1894,1321,1038,283,28650,36,111,955300
36111951500,3738,3074,1495,1127,368,37472,36,111,951500
36111955400,4205,2871,1239,905,334,45041,36,111,955400
36113070100,2552,2417,1129,760,369,54958,36,113,070100
36113070200,1950,1793,895,277,618,31970,36,113,070200
36113070300,3393,3134,1491,883,608,38986,36,113,070300
36113070400,3889,3655,1767,862,905,30000,36,113,070400
36113070500,2538,2279,1228,520,708,35244,36,113,070500
36113070602,1449,1363,749,686,63,53452,36,113,070602
36113070603,3652,3595,2031,1153,878,33591,36,113,070603
36113070604,2197,2111,966,752,214,37438,36,113,070604
36055011507,4430,4059,1724,1084,640,49029,36,055,011507
36055011601,5235,4817,2446,1820,626,51565,36,055,011601
36055011603,1199,1088,651,449,202,27604,36,055,011603
36055011604,2605,2389,1241,1031,210,49902,36,055,011604
36055011605,2009,1730,850,562,288,49000,36,055,011605
36055011705,2079,2006,879,725,154,58047,36,055,011705
36055011707,6660,6266,2488,2166,322,52982,36,055,011707
36055011708,3586,3413,1339,1206,133,59432,36,055,011708
36055011709,3075,2715,1017,1002,15,84327,36,055,011709
36055011710,6870,5757,2640,2112,528,54778,36,055,011710
36055011711,1939,1866,985,651,334,51429,36,055,011711
36055011712,5236,4794,2311,1845,466,54782,36,055,011712
36055011800,5296,5227,2605,1749,856,52967,36,055,011800
36055011901,6011,4993,2574,1848,726,45694,36,055,011901
36055011903,2011,1839,830,810,20,66046,36,055,011903
36055011904,4022,3765,1823,1432,391,40489,36,055,011904
36055012000,2668,2330,1265,732,533,33921,36,055,012000
36055012100,3862,3416,1706,1163,543,27255,36,055,012100
36055012201,5877,5077,1370,1046,324,6823,36,055,012201
36055012202,3580,3107,1484,1154,330,49907,36,055,012202
36055012301,5904,4970,2340,1778,562,57168,36,055,012301
36055012304,4120,3699,1423,1353,70,52939,36,055,012304
36055012305,3970,3336,1435,1398,37,73594,36,055,012305
36055012307,2382,1536,756,707,49,81495,36,055,012307
36055012308,3613,3181,1420,1297,123,51500,36,055,012308
36055012401,3130,3012,1289,746,543,36486,36,055,012401
36055012402,6101,5808,2220,2069,151,62059,36,055,012402
36055012500,4460,4064,2231,1440,791,48958,36,055,012500
36055012600,4722,4286,2240,1355,885,64848,36,055,012600
36055012700,3685,3136,1360,1125,235,59853,36,055,012700
36055012800,4350,3520,2170,916,1254,39911,36,055,012800
36055012900,5200,4075,2315,1383,932,65434,36,055,012900
36055013003,1438,1081,512,496,16,60184,36,055,013003
36055013004,5071,3629,2221,1064,1157,42295,36,055,013004
36055013005,5074,3144,1416,287,1129,13019,36,055,013005
36055013006,2163,1432,936,337,599,24107,36,055,013006
36055013101,7063,5133,2962,2542,420,42462,36,055,013101
36055013103,6514,4573,771,384,387,4878,36,055,013103
36055013104,4086,2773,1857,876,981,22374,36,055,013104
36055013203,5800,4782,2294,1903,391,41875,36,055,013203
36055013205,4827,3352,1690,1106,584,30799,36,055,013205
36055013206,6777,4504,2650,1902,748,42434,36,055,013206
36055013207,6040,5023,2278,1640,638,49896,36,055,013207
36055013208,2337,1991,1002,634,368,27955,36,055,013208
36055013300,3454,3232,1389,1313,76,49286,36,055,013300
36055013401,3995,2989,2038,661,1377,32199,36,055,013401
36063022601,2467,2369,1021,791,230,36354,36,063,022601
36063022602,5644,4955,2480,1871,609,29554,36,063,022602
36063022702,6745,6463,2515,2330,185,42943,36,063,022702
36063022713,2948,2866,1214,840,374,48078,36,063,022713
36063022714,4319,4004,1793,1167,626,41625,36,063,022714
36063022715,2056,1957,738,726,12,47414,36,063,022715
36063022716,3379,3379,1414,1083,331,47546,36,063,022716
36063022717,5403,5191,1831,1727,104,54640,36,063,022717
36063022803,3294,3275,1462,1362,100,49628,36,063,022803
36063022804,3457,3297,1529,1369,160,42325,36,063,022804
36063022901,2498,2484,1073,584,489,35659,36,063,022901
36063022902,2917,2663,1269,1051,218,36853,36,063,022902
36063023001,2179,2117,979,619,360,30544,36,063,023001
36063023100,2226,2078,990,526,464,33627,36,063,023100
36063023200,2817,2630,1479,651,828,38444,36,063,023200
36063023301,3058,2941,1287,1048,239,38621,36,063,023301
36063023302,3201,2917,1787,733,1054,40064,36,063,023302
36063023401,7342,5907,2731,2246,485,41389,36,063,023401
36063023402,4724,4465,1857,1733,124,43520,36,063,023402
36063023404,4352,3917,1804,1189,615,49167,36,063,023404
36063023405,3555,3213,1692,1389,303,35289,36,063,023405
36063023500,2818,2235,1072,600,472,26132,36,063,023500
36063023600,3920,3002,1553,781,772,31036,36,063,023600
36063023700,1810,1399,1002,286,716,25583,36,063,023700
36063023800,3066,2511,1396,869,527,35872,36,063,023800
36063023901,4105,3423,1799,1187,612,40342,36,063,023901
36063023902,4701,3852,2291,1331,960,38512,36,063,023902
36063024001,5893,5492,2260,1805,455,40376,36,063,024001
36063024002,1889,1744,769,506,263,32350,36,063,024002
36063024101,3717,3665,1517,1363,154,33944,36,063,024101
36063024102,2577,2249,1012,831,181,39485,36,063,024102
36063024201,6595,6275,2476,2100,376,38159,36,063,024201
36063024202,2744,2551,1153,949,204,35195,36,063,024202
36063024301,1309,1129,589,452,137,36827,36,063,024301
36063024302,4497,4248,1855,1738,117,38063,36,063,024302
36063024303,5751,5601,2466,2044,422,44660,36,063,024303
36063024401,2582,2536,1307,811,496,27343,36,063,024401
36063024404,4348,4037,1784,1505,279,43640,36,063,024404
36063024405,5433,5214,2286,1884,402,34743,36,063,024405
36063024406,3419,3021,883,808,75,11376,36,063,024406
36063024501,2685,2543,1120,962,158,41190,36,063,024501
36063024502,3869,3772,1543,1297,246,50514,36,063,024502
36063024600,4691,4442,2015,1751,264,34620,36,063,024600
36063940001,1167,454,599,563,36,35658,36,063,940001
36063940100,0,0,0,0,0,-666666666,36,063,940100
36081028801,2712,160,718,488,230,40035,36,081,028801
36081028802,1970,344,616,492,124,32515,36,081,028802
36081028803,0,0,0,0,0,-666666666,36,081,028803
36081028900,5250,2699,1830,567,1263,50701,36,081,028900
36081029100,6490,1652,2224,644,1580,32506,36,081,029100
36081029300,1123,210,340,133,207,37365,36,081,029300
36081029400,6919,313,2260,906,1354,43711,36,081,029400
36081029500,3675,1631,1624,910,714,52641,36,081,029500
36081029700,2006,1270,644,351,293,42727,36,081,029700
36081029900,0,0,0,0,0,-666666666,36,081,029900
36081030600,4983,250,1304,989,315,48214,36,081,030600
36081030903,5356,1323,1703,1047,656,38936,36,081,030903
36081030904,2801,1279,1025,396,629,39605,36,081,030904
36081030905,2853,964,1030,392,638,42440,36,081,030905
36081030906,3249,1437,1109,318,791,30625,36,081,030906
36081031700,5216,4343,2073,1230,843,52571,36,081,031700
36081032000,4626,296,1063,530,533,30894,36,081,032000
36081032700,3328,747,873,364,509,25763,36,081,032700
36081032800,2734,32,786,480,306,40135,36,081,032800
36081032900,3390,1280,897,660,237,25813,36,081,032900
36081033000,7254,90,2035,1466,569,38566,36,081,033000
36081033100,0,0,0,0,0,-666666666,36,081,033100
36081033401,3713,54,1205,741,464,50957,36,081,033401
36081033403,4349,39,2171,277,1894,45632,36,081,033403
36081033404,5220,73,2571,278,2293,37721,36,081,033404
36081033405,2603,222,1518,533,985,41790,36,081,033405
36081033700,2607,1170,835,641,194,40825,36,081,033700
36081033900,2666,1330,1047,689,358,39063,36,081,033900
36081034700,2840,747,889,399,490,31716,36,081,034700
36081035100,3480,1219,1381,984,397,33184,36,081,035100
36081035200,2643,40,865,729,136,50083,36,081,035200
36081035300,2139,418,660,361,299,32530,36,081,035300
36081035700,3507,813,899,499,400,32447,36,081,035700
36081035800,4430,216,1317,773,544,41260,36,081,035800
36081036100,2196,325,634,264,370,28800,36,081,036100
36081036300,1801,212,489,208,281,28095,36,081,036300
36081036500,2794,300,785,380,405,30091,36,081,036500
36081036600,2795,97,1005,619,386,41230,36,081,036600
36081036700,2098,409,650,384,266,40149,36,081,036700
36081036800,2383,12,742,578,164,40549,36,081,036800
36081037100,1211,144,467,401,66,57426,36,081,037100
36081037300,2345,250,551,236,315,30565,36,081,037300
36081037501,1482,581,285,75,210,30422,36,081,037501
36081037502,2542,583,615,152,463,30085,36,081,037502
36081037600,6222,125,1816,1269,547,44966,36,081,037600
36081037700,3896,846,742,214,528,27264,36,081,037700
36087012503,2492,1928,642,412,230,42454,36,087,012503
36087012504,2877,2132,865,735,130,61094,36,087,012504
36087012505,2297,1998,600,484,116,55239,36,087,012505
36087012506,2793,2305,754,584,170,55114,36,087,012506
36087012600,6100,4626,1867,1521,346,52052,36,087,012600
36087012700,4480,3436,1758,1027,731,61924,36,087,012700
36087012800,7330,6568,2566,2221,345,65027,36,087,012800
36087013001,2717,2051,753,675,78,49352,36,087,013001
36087013002,5413,4316,1643,1423,220,57934,36,087,013002
36087013003,3241,2601,1120,805,315,46208,36,087,013003
36087013101,3560,2578,1275,466,809,46500,36,087,013101
36087013102,2773,2230,1554,677,877,75250,36,087,013102
36087013200,3359,2046,1257,692,565,45850,36,087,013200
36087013300,2541,2131,1224,779,445,63589,36,087,013300
36087013401,4331,3587,1440,1329,111,61324,36,087,013401
36087013402,3973,3154,1370,1271,99,54614,36,087,013402
36089490100,3348,3169,1746,973,773,31079,36,089,490100
36089490200,3503,3306,1693,1215,478,40719,36,089,490200
36089490300,5289,4915,2463,1568,895,31534,36,089,490300
36089490400,3030,2979,1111,885,226,50841,36,089,490400
36089490500,3736,3628,1529,1173,356,37536,36,089,490500
36089490600,4504,4403,1904,1390,514,31101,36,089,490600
36089490700,6181,5967,2420,1841,579,35704,36,089,490700
36089490800,3455,3227,1384,721,663,15702,36,089,490800
36089490900,3145,2914,1623,735,888,26686,36,089,490900
36089491000,4697,4429,2077,1717,360,40453,36,089,491000
36089491100,2150,1649,4,0,4,4228,36,089,491100
36089491200,1964,1394,0,0,0,3424,36,089,491200
36089491300,4051,3965,1439,1270,169,34832,36,089,491300
36089491400,5182,3803,1606,1074,532,39853,36,089,491400
36089491500,3381,3126,1599,984,615,44674,36,089,491500
36089491600,1996,1956,822,512,310,26563,36,089,491600
36089491700,4307,4182,1542,1296,246,32215,36,089,491700
36089491800,4773,4614,1551,1335,216,28203,36,089,491800
36089491900,1651,1310,0,0,0,4315,36,089,491900
36089492000,4798,4551,1981,1322,659,46419,36,089,492000
36089492100,4606,4127,1750,980,770,24887,36,089,492100
36089492301,2855,2788,1268,1015,253,39453,36,089,492301
36089492302,2611,2480,1081,939,142,44524,36,089,492302
36089492401,1994,1914,826,718,108,31250,36,089,492401
36089492501,2053,1897,906,753,153,26369,36,089,492501
36089492600,5730,5605,2379,2072,307,31035,36,089,492600
36089492700,7019,5891,2774,1858,916,30403,36,089,492700
36089492800,3027,2858,1167,978,189,27148,36,089,492800
36089492900,2156,2120,779,625,154,29707,36,089,492900
36113070701,3422,3266,1714,750,964,43680,36,113,070701
36113070702,5163,4914,2214,1780,434,46895,36,113,070702
36113070801,3405,3137,1496,1354,142,40817,36,113,070801
36113070802,3529,3421,1407,1090,317,40180,36,113,070802
36113070900,4602,4497,1659,1546,113,56842,36,113,070900
36113071000,3263,3226,1602,1284,318,36690,36,113,071000
36113072001,1743,1626,850,546,304,31050,36,113,072001
36113072002,1676,1645,618,527,91,45024,36,113,072002
36113073000,3966,3871,1703,1158,545,31474,36,113,073000
36113073500,1717,1685,732,665,67,31265,36,113,073500
36113074000,2434,2304,1066,834,232,27407,36,113,074000
36113075001,1911,1853,894,684,210,31840,36,113,075001
36113075002,1359,1295,611,523,88,33125,36,113,075002
36113076000,2307,2192,1168,997,171,32174,36,113,076000
36113078000,2070,2016,1044,885,159,40449,36,113,078000
36115080100,4552,4275,2259,1004,1255,33242,36,115,080100
36115080200,2515,2303,1006,647,359,34680,36,115,080200
36115080301,3107,2761,1306,659,647,35720,36,115,080301
36115080302,2170,2049,788,587,201,35552,36,115,080302
36115081001,1922,1849,780,632,148,51250,36,115,081001
36115081002,4085,2199,609,542,67,32219,36,115,081002
36115082001,4955,4647,1891,1269,622,30412,36,115,082001
36115082002,1164,1118,539,485,54,33527,36,115,082002
36115084001,3290,3222,1319,963,356,40023,36,115,084001
36115084002,3153,3031,1471,1052,419,27087,36,115,084002
36115085000,1977,1910,767,638,129,38939,36,115,085000
36115086000,1815,1651,674,587,87,31116,36,115,086000
36115087000,3682,3626,1456,1253,203,36676,36,115,087000
36115088001,2809,2775,950,814,136,37601,36,115,088001
36115088002,3302,3227,1364,874,490,31759,36,115,088002
36115089000,4803,4552,1815,1428,387,35500,36,115,089000
36115090000,2638,2551,1094,756,338,32821,36,115,090000
36115091000,1846,1780,814,691,123,34519,36,115,091000
36115092000,3283,3188,1438,1158,280,37305,36,115,092000
36115093000,1839,1704,759,622,137,35685,36,115,093000
36115094000,2397,2355,955,833,122,37836,36,115,094000
36117020103,2464,2354,1056,1010,46,54297,36,117,020103
36117020104,2748,2354,1090,1082,8,39604,36,117,020104
36117020105,2799,2610,1204,849,355,43078,36,117,020105
36117020106,2101,1956,1062,581,481,29904,36,117,020106
36117020201,4444,4388,1806,1650,156,33616,36,117,020201
36117020202,4741,4301,1886,1688,198,50649,36,117,020202
36117020302,5418,4917,2145,1832,313,41747,36,117,020302
36117020303,3504,3395,1527,1185,342,43247,36,117,020303
36117020401,2745,2558,1111,1078,33,48256,36,117,020401
36055013402,3413,3080,1538,929,609,42960,36,055,013402
36055013503,5406,5002,2135,2135,0,50941,36,055,013503
36055013505,3859,3333,1763,936,827,31974,36,055,013505
36055013507,6252,5235,2229,1995,234,38198,36,055,013507
36055013508,4005,3735,1439,1387,52,40313,36,055,013508
36055013509,2578,2449,1179,759,420,43517,36,055,013509
36055013510,3530,3322,1330,1083,247,40969,36,055,013510
36055013511,2247,1575,865,628,237,39744,36,055,013511
36055013601,4280,3691,1914,1394,520,35112,36,055,013601
36055013603,5298,4985,2032,1888,144,40250,36,055,013603
36055013604,5989,4189,2472,1560,912,37191,36,055,013604
36055013701,2067,1818,946,661,285,33445,36,055,013701
36055013702,3775,3370,1504,1045,459,30189,36,055,013702
36055013800,5896,4661,2206,1754,452,34175,36,055,013800
36055013901,4002,3391,1729,1257,472,30871,36,055,013901
36055013902,3868,2938,1979,745,1234,30852,36,055,013902
36055014001,4826,3951,1913,1278,635,42146,36,055,014001
36055014003,4720,3764,2087,1431,656,33073,36,055,014003
36055014004,4106,3413,1725,771,954,25833,36,055,014004
36055014102,3560,2662,1617,1222,395,41492,36,055,014102
36055014103,4310,3809,1865,1558,307,51004,36,055,014103
36055014104,3867,3565,1688,995,693,41958,36,055,014104
36055014202,6904,5764,3213,2136,1077,41110,36,055,014202
36055014204,2243,1786,861,689,172,37642,36,055,014204
36055014205,2928,2343,1167,1013,154,37458,36,055,014205
36055014206,3802,2826,1676,1020,656,37436,36,055,014206
36055014301,3010,1970,1328,730,598,34467,36,055,014301
36055014302,4782,4263,1967,1726,241,35206,36,055,014302
36055014400,4700,3456,1807,1629,178,41555,36,055,014400
36055014501,4792,4535,2042,1824,218,40916,36,055,014501
36055014503,3197,2775,1283,1096,187,34669,36,055,014503
36055014504,5618,4547,2110,2068,42,41747,36,055,014504
36055014505,4668,3969,1891,1195,696,36649,36,055,014505
36055014601,5538,4800,2174,1681,493,45149,36,055,014601
36055014602,4769,3581,1903,1292,611,38772,36,055,014602
36055014700,4704,4358,1933,1290,643,34750,36,055,014700
36055014802,5357,5263,2096,1890,206,42184,36,055,014802
36055014803,3577,3345,1345,1321,24,44786,36,055,014803
36055014805,3356,3251,1326,741,585,29118,36,055,014805
36055014806,3437,3158,1109,952,157,47547,36,055,014806
36055014901,5723,5573,2327,1635,692,40714,36,055,014901
36055014903,5873,5631,1966,1777,189,43961,36,055,014903
36055014905,5435,4986,2056,1549,507,36069,36,055,014905
36055014906,3406,3152,1480,1049,431,45368,36,055,014906
36055015000,5643,5450,2120,1884,236,42392,36,055,015000
36055015101,4991,4811,1978,1801,177,33000,36,055,015101
36065020102,1416,616,607,183,424,31856,36,065,020102
36065020300,1106,616,618,73,545,34125,36,065,020300
36065020705,1899,1503,781,512,269,38224,36,065,020705
36065020802,3461,2344,1298,591,707,24142,36,065,020802
36065020803,2770,1215,938,218,720,17368,36,065,020803
36065020900,2108,710,714,238,476,23822,36,065,020900
36065021000,1483,685,666,107,559,17969,36,065,021000
36065021103,1214,777,582,221,361,21477,36,065,021103
36065021104,4075,2382,1357,426,931,19238,36,065,021104
36065021201,1939,696,632,299,333,27970,36,065,021201
36065021202,3115,906,967,639,328,28182,36,065,021202
36065021301,1176,1082,424,277,147,60099,36,065,021301
36065021302,4633,3651,1794,1227,567,27489,36,065,021302
36065021303,3362,2384,1083,746,337,24470,36,065,021303
36065021401,2412,1564,1037,646,391,23545,36,065,021401
36065021402,1827,1365,680,339,341,27255,36,065,021402
36065021500,2117,474,760,316,444,22713,36,065,021500
36065021601,5172,4319,2155,1570,585,36424,36,065,021601
36065021602,2482,2398,1044,783,261,35000,36,065,021602
36065021701,3112,2877,1381,1112,269,41034,36,065,021701
36065021702,2162,1945,991,633,358,40938,36,065,021702
36065021900,1663,1396,646,377,269,22500,36,065,021900
36065022000,3242,2536,1320,524,796,27598,36,065,022000
36065022100,2809,2787,1209,1060,149,37500,36,065,022100
36065022200,3050,2590,1265,859,406,53488,36,065,022200
36065022400,3464,3119,1472,813,659,37813,36,065,022400
36065022500,4542,3876,1965,540,1425,32884,36,065,022500
36065022701,2129,1896,981,692,289,45345,36,065,022701
36065022702,3742,3444,1578,1469,109,38667,36,065,022702
36065022800,2440,2359,930,839,91,41368,36,065,022800
36065023000,6066,5925,2331,2142,189,37355,36,065,023000
36065023200,4288,3800,2036,1062,974,31273,36,065,023200
36065023300,2575,2507,1072,653,419,30047,36,065,023300
36065023400,4617,4224,2089,1090,999,33883,36,065,023400
36065023501,2321,2267,912,874,38,48953,36,065,023501
36065023502,4302,3994,1737,1572,165,46409,36,065,023502
36065023702,3753,3601,1541,1348,193,41960,36,065,023702
36063990000,0,0,0,0,0,-666666666,36,063,990000
36065023901,2218,2066,952,926,26,43669,36,065,023901
36065023902,1842,1765,666,623,43,46797,36,065,023902
36065024000,4499,4347,1728,1458,270,45921,36,065,024000
36065024101,1581,1533,720,683,37,33650,36,065,024101
36065024102,2542,2519,1093,894,199,37557,36,065,024102
36065024200,4474,4249,1948,1402,546,39930,36,065,024200
36065024301,3088,2736,1335,1229,106,48229,36,065,024301
36065024302,3304,3164,1359,1155,204,33766,36,065,024302
36081037900,6321,2024,1408,265,1143,27665,36,081,037900
36081038100,6713,2536,1621,595,1026,25839,36,081,038100
36081038301,0,0,0,0,0,-666666666,36,081,038301
36081038302,0,0,0,0,0,-666666666,36,081,038302
36081038400,2331,35,718,557,161,41140,36,081,038400
36081039400,2884,22,847,589,258,39915,36,081,039400
36081039800,1695,83,488,407,81,52750,36,081,039800
36081039901,2475,1062,529,159,370,30509,36,081,039901
36081039902,1391,635,378,53,325,23472,36,081,039902
36081040000,1509,11,462,381,81,49063,36,081,040000
36081040101,2761,273,680,228,452,29093,36,081,040101
36081040102,4436,1465,1210,196,1014,30533,36,081,040102
36081040200,1557,12,486,452,34,46979,36,081,040200
36081040301,3139,824,711,74,637,28245,36,081,040301
36081040302,4156,1392,1009,301,708,21791,36,081,040302
36081040400,4095,134,1388,825,563,40308,36,081,040400
36081040501,1087,223,240,25,215,25254,36,081,040501
36081040502,2178,607,468,50,418,31612,36,081,040502
36081040701,3781,1065,890,12,878,19289,36,081,040701
36081040702,4510,410,907,212,695,23223,36,081,040702
36081040901,1605,684,324,114,210,30313,36,081,040901
36081040902,3120,590,658,49,609,26193,36,081,040902
36081041100,3884,1215,1080,415,665,26714,36,081,041100
36081041300,4668,1608,969,266,703,26760,36,081,041300
36081041400,4468,270,1383,713,670,32174,36,081,041400
36081041500,4259,1827,1239,346,893,25353,36,081,041500
36081042400,2314,22,803,651,152,40473,36,081,042400
36081042600,470,202,0,0,0,-666666666,36,081,042600
36081042700,4732,2016,1372,277,1095,25931,36,081,042700
36081043200,1227,9,372,279,93,43676,36,081,043200
36081043400,1841,98,555,488,67,44814,36,081,043400
36081043701,3007,1347,702,155,547,27449,36,081,043701
36081043702,6938,2596,2109,825,1284,26464,36,081,043702
36081043900,3411,1199,1007,233,774,25194,36,081,043900
36081044000,4165,89,1128,443,685,29112,36,081,044000
36081044301,3780,1436,1244,78,1166,21700,36,081,044301
36081044302,4104,673,1222,417,805,30880,36,081,044302
36081044400,3693,293,990,323,667,29241,36,081,044400
36081044601,3666,386,1178,235,943,31382,36,081,044601
36081044602,5016,421,1368,196,1172,25041,36,081,044602
36081044800,2911,245,841,287,554,34688,36,081,044800
36081045000,2154,427,564,349,215,31212,36,081,045000
36081045200,1238,210,187,113,74,31125,36,081,045200
36081045400,5017,337,1431,666,765,38650,36,081,045400
36081045500,14220,4372,4511,0,4511,34755,36,081,045500
36081045600,1442,155,442,392,50,30321,36,081,045600
36089493000,1160,1141,501,438,63,40385,36,089,493000
36091060102,5996,5891,2565,1861,704,40823,36,091,060102
36091060103,1536,1456,623,607,16,60074,36,091,060103
36091060104,4336,4095,1698,1368,330,42034,36,091,060104
36091060200,3612,3485,1693,789,904,28628,36,091,060200
36091060301,3194,3174,1238,1088,150,30338,36,091,060301
36091060400,2627,2513,1019,652,367,31955,36,091,060400
36091060501,2017,1995,827,701,126,46667,36,091,060501
36091060504,996,971,499,418,81,37500,36,091,060504
36091060505,1062,1009,528,479,49,32155,36,091,060505
36091060506,1669,1492,612,523,89,37244,36,091,060506
36091060507,379,379,145,128,17,27969,36,091,060507
36091060601,2842,2741,1219,771,448,46761,36,091,060601
36091060602,4907,4727,1961,1620,341,49530,36,091,060602
36091060703,3199,3199,1210,911,299,38277,36,091,060703
36091060704,4381,4112,1936,1450,486,39747,36,091,060704
36091060705,4387,4206,1851,1002,849,40243,36,091,060705
36091060706,4953,4717,1853,1732,121,59304,36,091,060706
36091060800,5099,4796,1949,1807,142,46038,36,091,060800
36091060901,3831,3368,1456,1295,161,48971,36,091,060901
36091060902,1865,1816,770,449,321,37760,36,091,060902
36091061001,2880,2777,1606,533,1073,51382,36,091,061001
36091061002,2093,1774,1133,265,868,31996,36,091,061002
36091061101,2244,1781,1151,621,530,33854,36,091,061101
36091061102,3309,2954,1469,1003,466,53864,36,091,061102
36091061201,2276,1963,971,285,686,52679,36,091,061201
36091061202,3167,2784,1719,843,876,42217,36,091,061202
36091061301,3637,3381,1557,1210,347,73344,36,091,061301
36091061303,1937,1372,3,3,0,2499,36,091,061303
36091061304,3077,2934,1274,1196,78,63621,36,091,061304
36091061305,3436,3061,1667,1038,629,39866,36,091,061305
36091061401,4842,4684,1874,1527,347,42563,36,091,061401
36091061403,6948,6693,3046,2347,699,41475,36,091,061403
36091061404,3070,2873,1157,995,162,61594,36,091,061404
36091061500,3547,3529,1404,1255,149,49015,36,091,061500
36091061600,4180,3981,1682,1627,55,50074,36,091,061600
36091061701,5776,5350,2240,1683,557,47485,36,091,061701
36091061702,4217,4144,1641,1334,307,53355,36,091,061702
36091061800,5681,5298,2316,1446,870,41573,36,091,061800
36091061904,5783,5322,2739,1840,899,59036,36,091,061904
36091061905,3232,2931,1569,1056,513,56379,36,091,061905
36091061906,3093,2764,1350,711,639,57101,36,091,061906
36091061907,4022,3766,1900,1483,417,57366,36,091,061907
36091062001,4228,4047,1660,1406,254,51575,36,091,062001
36091062002,2702,2699,1185,1031,154,51181,36,091,062002
36117020402,3993,3681,1623,1034,589,34940,36,117,020402
36117020500,4571,4272,1833,1479,354,31770,36,117,020500
36117020601,1912,1899,851,723,128,41557,36,117,020601
36117020602,2210,2153,979,860,119,35239,36,117,020602
36117020700,3422,3286,1589,769,820,30576,36,117,020700
36117020800,3145,2891,1535,1431,104,40340,36,117,020800
36117020900,4901,4227,2061,1553,508,27011,36,117,020900
36117021000,6309,6143,2360,2106,254,31250,36,117,021000
36117021100,5019,3918,2021,1226,795,30359,36,117,021100
36117021200,4470,3970,1894,1048,846,28584,36,117,021200
36117021400,3182,2355,1244,884,360,30093,36,117,021400
36117021501,2130,2000,881,775,106,44432,36,117,021501
36117021502,4106,3903,1782,1411,371,32040,36,117,021502
36117021600,3963,3669,1535,1203,332,30459,36,117,021600
36117021700,3974,3716,1412,1095,317,25195,36,117,021700
36117021800,1832,1683,794,562,232,33790,36,117,021800
36117990100,0,0,0,0,0,-666666666,36,117,990100
36119000101,4007,1024,1490,264,1226,24792,36,119,000101
36119000103,5064,1020,2202,247,1955,31203,36,119,000103
36119000104,1326,313,709,92,617,140164,36,119,000104
36119000202,4498,1649,1565,809,756,34200,36,119,000202
36119000203,3642,1745,1641,664,977,45000,36,119,000203
36119000204,2972,754,1179,193,986,25181,36,119,000204
36119000205,3794,805,1344,262,1082,28026,36,119,000205
36119000300,4099,1193,1550,0,1550,30326,36,119,000300
36119000401,4194,1554,1839,101,1738,42455,36,119,000401
36119000403,3197,587,1375,147,1228,40292,36,119,000403
36119000404,3343,679,962,366,596,31250,36,119,000404
36119000501,3069,447,882,273,609,23022,36,119,000501
36119000502,1760,535,920,14,906,15859,36,119,000502
36119000601,2688,1173,946,76,870,25870,36,119,000601
36119000602,4086,1089,1356,410,946,29722,36,119,000602
36119000701,3727,2156,1537,1018,519,52448,36,119,000701
36119000702,4454,2031,2312,1015,1297,54213,36,119,000702
36119000801,5898,3214,2447,1844,603,52674,36,119,000801
36119000802,2150,1066,724,493,231,38553,36,119,000802
36119000803,5745,3230,1686,907,779,47066,36,119,000803
36119000900,3229,1401,1001,799,202,57768,36,119,000900
36119001000,1963,371,776,65,711,23173,36,119,001000
36119001101,3247,654,1005,53,952,22912,36,119,001101
36119001102,5810,1766,1930,635,1295,30349,36,119,001102
36119001200,4204,1205,1489,333,1156,29224,36,119,001200
36119001301,3762,1610,1298,901,397,38750,36,119,001301
36119001302,4317,1142,1438,317,1121,26888,36,119,001302
36119001304,3389,1281,1040,53,987,23405,36,119,001304
36055015102,4007,3937,1615,1394,221,36181,36,055,015102
36055015200,7096,6395,2827,1960,867,37392,36,055,015200
36055015301,2617,1946,72,4,68,3619,36,055,015301
36055015303,3104,2706,1235,640,595,27434,36,055,015303
36055015304,4121,3803,1833,941,892,27741,36,055,015304
36055015400,4135,3886,1508,1185,323,33036,36,055,015400
36055980000,0,0,0,0,0,-666666666,36,055,980000
36055980100,25,13,9,9,0,-666666666,36,055,980100
36055980200,51,51,24,24,0,-666666666,36,055,980200
36055990000,0,0,0,0,0,-666666666,36,055,990000
36057070200,2101,1626,978,354,624,27614,36,057,070200
36057070300,2115,1652,860,379,481,22299,36,057,070300
36057070400,2157,1703,854,449,405,33199,36,057,070400
36057070500,2392,2138,999,731,268,32159,36,057,070500
36057070600,2047,1139,781,319,462,26286,36,057,070600
36057070700,2391,2035,1135,776,359,33590,36,057,070700
36057070800,3056,1587,1114,406,708,18224,36,057,070800
36057070900,1564,883,734,276,458,26326,36,057,070900
36057072100,5996,5793,2798,2198,600,42432,36,057,072100
36057072200,3767,3528,1360,1162,198,40744,36,057,072200
36057072300,3231,2944,1325,956,369,38785,36,057,072300
36057072400,2524,2400,958,621,337,25767,36,057,072400
36057072500,4170,3926,1389,999,390,28050,36,057,072500
36057072600,3594,3441,1356,957,399,38602,36,057,072600
36057072700,4179,3926,1372,1196,176,30768,36,057,072700
36057072800,4010,3904,1608,1462,146,40760,36,057,072800
36059300100,5250,4734,1186,1153,33,41630,36,059,300100
36059300300,3980,2930,1271,935,336,47188,36,059,300300
36059300400,6192,4979,1833,1457,376,59299,36,059,300400
36059300500,5762,5021,1812,1497,315,62917,36,059,300500
36059300600,6406,4065,2396,1991,405,68233,36,059,300600
36059300700,5956,4076,3142,1862,1280,66563,36,059,300700
36059300800,4310,2213,1588,1281,307,50720,36,059,300800
36059300901,3228,1429,807,756,51,59097,36,059,300901
36059300902,5867,3965,2632,2147,485,86391,36,059,300902
36059301000,5665,5081,2079,1894,185,108259,36,059,301000
36059301101,6725,4279,2471,1014,1457,41347,36,059,301101
36059301102,4700,3737,1880,1282,598,80299,36,059,301102
36059301200,5960,5354,2220,1678,542,69907,36,059,301200
36059301300,4916,2971,1546,970,576,61785,36,059,301300
36059301400,2032,1704,690,640,50,95313,36,059,301400
36059301500,2922,2475,943,916,27,116979,36,059,301500
36059301600,4883,3934,1515,1358,157,116875,36,059,301600
36059301700,2696,2350,819,773,46,104453,36,059,301700
36059301800,4841,2593,1563,1007,556,53016,36,059,301800
36059301900,2951,2219,925,915,10,88542,36,059,301900
36065024303,2710,2671,1100,960,140,36392,36,065,024303
36065024400,4294,4067,1655,1416,239,30879,36,065,024400
36065024500,4845,4770,2315,1802,513,41627,36,065,024500
36065024700,6172,6011,2418,2048,370,35894,36,065,024700
36065024800,2987,2843,1307,938,369,42793,36,065,024800
36065024900,5339,5059,2267,1581,686,41501,36,065,024900
36065025001,2787,2440,1231,821,410,40469,36,065,025001
36065025002,4081,3894,1865,1052,813,55851,36,065,025002
36065025003,3198,2826,541,506,35,6243,36,065,025003
36065025100,1811,1689,911,569,342,49348,36,065,025100
36065025200,4657,4203,2160,1644,516,40576,36,065,025200
36065025300,6940,6363,3021,2177,844,50802,36,065,025300
36065025400,5890,5516,2253,1907,346,47564,36,065,025400
36065025500,4231,3880,1735,1449,286,42413,36,065,025500
36065025601,2133,2025,895,786,109,44472,36,065,025601
36065025602,2291,2200,885,704,181,32475,36,065,025602
36065025700,2331,2299,1032,710,322,39286,36,065,025700
36065025800,1386,1367,545,463,82,34671,36,065,025800
36065025900,1624,773,4,0,4,14336,36,065,025900
36065026100,2527,2219,916,715,201,38382,36,065,026100
36065026200,7247,7155,2554,2159,395,46782,36,065,026200
36065026300,3508,3164,1718,312,1406,31034,36,065,026300
36065026400,5925,1614,1929,441,1488,19287,36,065,026400
36065026501,851,584,0,0,0,4268,36,065,026501
36065026502,167,85,5,5,0,10375,36,065,026502
36065026600,2213,1250,0,0,0,11178,36,065,026600
36065026700,5333,5280,2015,1709,306,38527,36,065,026700
36065980002,0,0,0,0,0,-666666666,36,065,980002
36065980003,0,0,0,0,0,-666666666,36,065,980003
36065980100,4,4,4,4,0,-666666666,36,065,980100
36067000100,871,739,555,70,485,45833,36,067,000100
36067000200,3250,1768,1383,560,823,33438,36,067,000200
36067000300,1507,742,640,402,238,34357,36,067,000300
36067000400,4203,2798,1585,1131,454,35977,36,067,000400
36067000501,2480,858,899,77,822,27375,36,067,000501
36067000600,2931,1136,1215,234,981,20417,36,067,000600
36067000700,1410,566,529,171,358,27220,36,067,000700
36067000800,3135,1328,1109,443,666,22265,36,067,000800
36067000900,3602,2820,1454,918,536,48925,36,067,000900
36067001000,3883,2433,2029,692,1337,30408,36,067,001000
36067001400,3362,936,879,306,573,24003,36,067,001400
36067001500,2585,1314,795,272,523,28826,36,067,001500
36067001600,3407,2025,1936,115,1821,25369,36,067,001600
36067001701,2337,1599,1191,748,443,48333,36,067,001701
36067001702,2750,1875,1085,526,559,35993,36,067,001702
36067001800,3071,2280,1438,761,677,31858,36,067,001800
36081045700,3557,673,1055,438,617,27185,36,081,045700
36081045800,2259,290,665,302,363,40912,36,081,045800
36081045900,4196,336,999,412,587,36961,36,081,045900
36081046000,6156,555,1939,317,1622,28704,36,081,046000
36081046100,2639,509,711,173,538,27351,36,081,046100
36081046200,6355,264,2144,617,1527,30102,36,081,046200
36081046300,3679,353,1020,372,648,30531,36,081,046300
36081046400,2000,612,537,245,292,28520,36,081,046400
36081046500,4189,1463,976,275,701,25602,36,081,046500
36081046600,3891,405,1308,451,857,41081,36,081,046600
36081046700,5909,1652,1870,170,1700,28668,36,081,046700
36081046800,3426,177,978,448,530,35949,36,081,046800
36081046901,4026,283,1434,590,844,24132,36,081,046901
36081046902,3800,377,1163,154,1009,27374,36,081,046902
36081047000,3452,186,875,519,356,26875,36,081,047000
36081047100,4381,398,1417,278,1139,27294,36,081,047100
36081047200,3769,1201,1306,661,645,47768,36,081,047200
36081047300,4254,687,1681,582,1099,32273,36,081,047300
36081047500,4651,718,1451,476,975,32995,36,081,047500
36081047600,1435,619,505,402,103,57361,36,081,047600
36081047801,3630,1037,1795,1350,445,52063,36,081,047801
36081047802,1090,43,401,87,314,32983,36,081,047802
36081047900,5737,460,1751,658,1093,34360,36,081,047900
36081048000,2307,130,656,494,162,35168,36,081,048000
36081048100,6985,1129,2088,705,1383,30539,36,081,048100
36081048200,1289,180,422,233,189,44926,36,081,048200
36081048301,1997,318,629,267,362,32686,36,081,048301
36081048302,1948,582,548,117,431,40948,36,081,048302
36081048400,4901,228,1387,947,440,44677,36,081,048400
36081048500,4427,390,1450,642,808,30227,36,081,048500
36081048900,1490,403,421,188,233,30028,36,081,048900
36081049201,3111,411,1220,75,1145,37222,36,081,049201
36081049202,2525,140,590,449,141,34904,36,081,049202
36081049301,2129,1000,690,417,273,42750,36,081,049301
36081049302,3150,1573,969,512,457,31648,36,081,049302
36081049500,1600,1253,508,215,293,51927,36,081,049500
36081049600,3214,379,889,742,147,41514,36,081,049600
36081049700,3112,1504,915,473,442,30383,36,081,049700
36081049900,5556,1031,1622,764,858,32257,36,081,049900
36081050000,4378,247,1513,139,1374,30223,36,081,050000
36081050201,1390,27,411,301,110,25076,36,081,050201
36081050202,1327,21,394,318,76,37357,36,081,050202
36081050400,1731,60,523,341,182,36510,36,081,050400
36081050500,1716,949,525,311,214,42171,36,081,050500
36081050600,1540,74,446,359,87,36952,36,081,050600
36081050700,3722,2357,1310,623,687,41205,36,081,050700
36091062100,1959,1855,746,479,267,37123,36,091,062100
36091062200,2948,2822,1472,472,1000,38542,36,091,062200
36091062300,2129,1890,959,398,561,27039,36,091,062300
36091062404,2778,2691,1306,998,308,46282,36,091,062404
36091062406,4086,3600,1503,1052,451,44219,36,091,062406
36091062407,4095,3635,1916,1062,854,50439,36,091,062407
36091062408,2768,2622,1334,1235,99,51529,36,091,062408
36091062409,2818,2588,1297,866,431,47640,36,091,062409
36091062410,3575,2789,1703,422,1281,35407,36,091,062410
36091062501,4923,4314,1818,1764,54,53886,36,091,062501
36091062503,6372,5256,2224,1833,391,59469,36,091,062503
36091062505,4318,4011,1529,1450,79,62218,36,091,062505
36091062506,4664,3951,1970,1713,257,55653,36,091,062506
36091062507,4165,3475,1601,1183,418,52517,36,091,062507
36091062508,4236,3746,1705,1197,508,51663,36,091,062508
36091062509,3055,2841,1329,966,363,43935,36,091,062509
36091062601,2891,2736,1077,1030,47,64097,36,091,062601
36091062602,6183,4865,2452,2001,451,72049,36,091,062602
36091062700,6341,6068,2671,1904,767,43805,36,091,062700
36091062800,2141,1919,1032,477,555,38886,36,091,062800
36091062900,603,580,289,237,52,28086,36,091,062900
36093020101,2214,1386,1132,561,571,52541,36,093,020101
36093020102,2220,1232,1025,412,613,27443,36,093,020102
36093020200,2154,1044,1078,436,642,36806,36,093,020200
36093020300,1909,1212,572,148,424,5424,36,093,020300
36093020500,5203,4277,1909,1560,349,43740,36,093,020500
36093020600,3403,2760,1043,638,405,43340,36,093,020600
36093020700,5446,2049,1687,952,735,27060,36,093,020700
36093020800,3787,1798,1278,212,1066,25706,36,093,020800
36093020900,3621,748,1201,231,970,29468,36,093,020900
36093021001,1221,431,569,20,549,32109,36,093,021001
36093021002,2486,1172,996,124,872,22167,36,093,021002
36093021200,3189,2206,1256,708,548,27123,36,093,021200
36093021400,2909,996,1041,400,641,20000,36,093,021400
36093021500,3381,1123,988,425,563,25342,36,093,021500
36093021600,3466,1487,1319,881,438,34719,36,093,021600
36093021700,3563,1380,1394,464,930,26458,36,093,021700
36093021801,2175,1580,845,696,149,48636,36,093,021801
36093021802,4291,3626,2120,836,1284,37034,36,093,021802
36093031901,5160,4199,1687,1597,90,60795,36,093,031901
36093031902,2636,2433,1129,830,299,51532,36,093,031902
36093032000,6634,5428,2512,1782,730,46478,36,093,032000
36093032101,5798,4665,1847,1708,139,73950,36,093,032101
36093032102,1887,1588,646,618,28,70298,36,093,032102
36093032200,4919,4671,1943,1457,486,42094,36,093,032200
36119001305,4211,849,1240,251,989,26394,36,119,001305
36119001401,4020,2309,1360,936,424,48504,36,119,001401
36119001402,1535,1287,623,538,85,55197,36,119,001402
36119001403,3234,2245,1302,742,560,53168,36,119,001403
36119001502,3051,2285,1307,687,620,64363,36,119,001502
36119001503,2344,1973,993,496,497,51977,36,119,001503
36119001504,5734,3467,1983,958,1025,46127,36,119,001504
36119001505,1836,996,915,576,339,55481,36,119,001505
36119001600,4259,1797,1423,398,1025,25596,36,119,001600
36119001701,3154,1962,1052,744,308,46748,36,119,001701
36119001702,2901,2769,1310,1147,163,50708,36,119,001702
36119001800,1620,275,590,443,147,56815,36,119,001800
36119001900,1554,1090,564,501,63,60938,36,119,001900
36119002000,3871,2431,1396,1315,81,50087,36,119,002000
36119002101,3947,1897,1536,777,759,49042,36,119,002101
36119002103,2873,2730,1036,1018,18,94107,36,119,002103
36119002104,5341,2782,2126,1608,518,47264,36,119,002104
36119002105,1629,987,652,582,70,54750,36,119,002105
36119002106,2424,733,873,82,791,34180,36,119,002106
36119002107,1862,764,604,223,381,51625,36,119,002107
36119002201,2240,1722,859,760,99,65263,36,119,002201
36119002202,4756,3904,2311,1904,407,76490,36,119,002202
36119002203,1745,845,1018,570,448,61905,36,119,002203
36119002204,5062,3341,1891,1483,408,32925,36,119,002204
36119002300,3707,2251,1269,654,615,54134,36,119,002300
36119002401,2099,1454,776,279,497,52772,36,119,002401
36119002402,3663,1969,2136,1274,862,68675,36,119,002402
36119002403,5071,2713,1956,1157,799,38943,36,119,002403
36119002404,3764,2688,1106,762,344,38309,36,119,002404
36119002405,3042,2188,1014,639,375,41728,36,119,002405
36119002600,4327,293,1270,702,568,44163,36,119,002600
36119002700,4020,186,1107,380,727,31285,36,119,002700
36119002800,2371,152,852,303,549,33599,36,119,002800
36119002900,4098,138,2178,271,1907,30752,36,119,002900
36119003000,2371,94,845,228,617,33476,36,119,003000
36119003100,3153,52,1348,80,1268,24501,36,119,003100
36119003200,2567,67,890,302,588,37880,36,119,003200
36119003300,3023,92,1198,540,658,48077,36,119,003300
36119003400,4327,874,1626,856,770,41185,36,119,003400
36119003500,1653,181,647,102,545,32188,36,119,003500
36119003600,3780,1052,1743,240,1503,42409,36,119,003600
36119003700,3325,1182,1539,569,970,48029,36,119,003700
36119003800,3619,1764,1862,644,1218,43636,36,119,003800
36119003900,3359,1474,1183,626,557,43688,36,119,003900
36119004001,3689,605,1564,38,1526,37601,36,119,004001
36059302000,5142,4202,2173,1601,572,91587,36,059,302000
36059302101,4801,3738,1400,1225,175,63005,36,059,302101
36059302102,3323,3067,1139,1139,0,100093,36,059,302102
36059302200,4024,2439,1270,952,318,50682,36,059,302200
36059302300,4456,2051,1422,1379,43,73015,36,059,302300
36059302400,4930,3222,1781,1781,0,54696,36,059,302400
36059302501,2692,1835,871,854,17,71875,36,059,302501
36059302502,2726,1969,903,840,63,65833,36,059,302502
36059302600,2451,1600,808,614,194,53056,36,059,302600
36059302700,4295,1711,1355,1214,141,52075,36,059,302700
36059302800,6355,2932,1893,1793,100,56498,36,059,302800
36059302900,4302,3142,1424,1398,26,72400,36,059,302900
36059303000,5722,2799,1663,1256,407,52516,36,059,303000
36059303101,3808,1589,1206,1114,92,70000,36,059,303101
36059303102,4032,1975,1296,1266,30,73516,36,059,303102
36059303203,3336,1328,1057,1010,47,69483,36,059,303203
36059303204,4751,2096,1458,1144,314,52319,36,059,303204
36059303301,2767,1866,907,817,90,62188,36,059,303301
36059303302,4499,3516,1660,1087,573,55476,36,059,303302
36059303400,2552,2250,838,826,12,79531,36,059,303400
36059303500,4918,4076,1700,1572,128,57358,36,059,303500
36059303600,7447,5301,3471,1509,1962,52377,36,059,303600
36059303700,6902,5101,2499,1808,691,57685,36,059,303700
36059303800,4966,3979,1812,1333,479,55665,36,059,303800
36059303900,3999,1433,1287,1240,47,67797,36,059,303900
36059304001,2262,1911,798,729,69,61728,36,059,304001
36059304002,4966,2704,1833,1082,751,46160,36,059,304002
36059304100,4380,970,1402,1046,356,40876,36,059,304100
36059304202,3315,965,852,674,178,31750,36,059,304202
36059304203,5863,895,1124,796,328,30613,36,059,304203
36059304204,5698,2232,1155,500,655,34116,36,059,304204
36059404300,3314,1678,1090,932,158,40900,36,059,404300
36059404400,5257,4654,1748,1461,287,73924,36,059,404400
36059404500,3928,2916,1517,1169,348,60000,36,059,404500
36059404600,4343,3661,1429,1234,195,76364,36,059,404600
36059404700,5990,4161,2046,1863,183,65784,36,059,404700
36059404800,5731,1445,1642,1382,260,36959,36,059,404800
36059404901,5105,356,1432,1353,79,42713,36,059,404901
36059404902,5537,489,1461,1084,377,43538,36,059,404902
36059405000,5798,1523,1420,1093,327,36630,36,059,405000
36059405100,8684,1536,2525,1969,556,44878,36,059,405100
36059405200,7142,2243,2053,1402,651,40072,36,059,405200
36059405301,3374,2479,1107,1004,103,51361,36,059,405301
36059405302,5025,4309,1574,1275,299,42487,36,059,405302
36059405400,8818,4300,2568,1943,625,47479,36,059,405400
36059405500,5435,3993,1618,1389,229,50910,36,059,405500
36067002000,2057,1614,942,348,594,25481,36,067,002000
36067002101,2686,1741,1236,203,1033,17120,36,067,002101
36067002300,1524,555,875,62,813,25763,36,067,002300
36067002400,2023,1189,968,199,769,29712,36,067,002400
36067002700,1787,1396,868,340,528,41450,36,067,002700
36067002901,2899,2434,1353,587,766,41673,36,067,002901
36067003000,1898,629,774,95,679,20833,36,067,003000
36067003200,3187,1774,1577,11,1566,35510,36,067,003200
36067003400,1361,574,744,50,694,21025,36,067,003400
36067003500,2203,1384,917,197,720,18239,36,067,003500
36067003601,2341,782,838,362,476,26307,36,067,003601
36067003602,2680,897,1031,589,442,31194,36,067,003602
36067003800,2330,921,789,301,488,19560,36,067,003800
36067003900,3181,1113,957,186,771,16053,36,067,003900
36067004000,1406,413,507,140,367,17431,36,067,004000
36067004200,2443,417,933,46,887,14776,36,067,004200
36067004301,1454,663,434,0,434,3549,36,067,004301
36067004302,7076,4602,645,16,629,3093,36,067,004302
36067004401,3144,2407,1216,505,711,21391,36,067,004401
36067004500,2147,1645,797,286,511,21287,36,067,004500
36067004600,4515,3346,1938,1598,340,46306,36,067,004600
36067004800,1448,1277,675,623,52,52426,36,067,004800
36067004900,1384,931,546,381,165,46864,36,067,004900
36067005000,2319,1445,1014,770,244,50870,36,067,005000
36067005100,2421,416,905,310,595,30155,36,067,005100
36067005200,1965,309,695,225,470,27078,36,067,005200
36067005300,1891,152,584,187,397,18615,36,067,005300
36067005400,2245,249,814,274,540,24962,36,067,005400
36067005500,3474,1489,1796,220,1576,21620,36,067,005500
36067005601,1699,1289,757,486,271,37724,36,067,005601
36067005602,3958,2299,38,4,34,3192,36,067,005602
36067005700,1761,577,724,529,195,35588,36,067,005700
36067005800,1959,364,730,296,434,21477,36,067,005800
36067005900,1620,329,608,378,230,33750,36,067,005900
36067006000,3512,2116,1618,991,627,33260,36,067,006000
36067006101,3798,1352,1435,720,715,28038,36,067,006101
36067006102,1957,1165,1375,71,1304,23929,36,067,006102
36067001900,3800,2927,2001,1150,851,34595,36,067,001900
36067006103,2197,1757,998,904,94,39987,36,067,006103
36067010100,2569,2350,1012,940,72,53125,36,067,010100
36067010200,5813,5393,2301,1527,774,45462,36,067,010200
36067010301,5267,4988,2432,1697,735,40600,36,067,010301
36067010321,3086,2917,1024,976,48,47311,36,067,010321
36067010322,3383,3233,1234,1126,108,52028,36,067,010322
36067010400,4009,3758,1532,1251,281,54850,36,067,010400
36067010500,2598,2394,905,830,75,49667,36,067,010500
36081051000,1735,46,451,378,73,45988,36,081,051000
36081051100,2292,1559,716,451,265,56522,36,081,051100
36081051200,2518,28,649,497,152,38887,36,081,051200
36081051300,2530,1638,794,537,257,51722,36,081,051300
36081051500,3501,2805,1153,835,318,53250,36,081,051500
36081051600,2040,422,553,434,119,44450,36,081,051600
36081051700,1910,1664,740,398,342,48484,36,081,051700
36081051800,2073,23,618,491,127,32487,36,081,051800
36081052000,1313,61,428,293,135,32139,36,081,052000
36081052100,2025,1447,647,423,224,53860,36,081,052100
36081052200,1728,0,479,448,31,33047,36,081,052200
36081052400,1815,83,537,411,126,43208,36,081,052400
36081052500,2516,1543,813,488,325,41753,36,081,052500
36081052600,2131,120,715,509,206,48042,36,081,052600
36081052800,1480,0,462,310,152,40536,36,081,052800
36081053000,2418,51,572,465,107,37143,36,081,053000
36081053100,3624,2472,1416,569,847,43962,36,081,053100
36081053200,2184,15,590,428,162,43370,36,081,053200
36081053401,2066,162,571,461,110,45464,36,081,053401
36081053501,1315,869,463,215,248,51071,36,081,053501
36081053502,0,0,0,0,0,-666666666,36,081,053502
36081053601,2297,34,773,355,418,38875,36,081,053601
36081053800,1728,9,437,373,64,38625,36,081,053800
36081053901,4285,2586,1453,619,834,43125,36,081,053901
36081053902,169,169,73,73,0,87500,36,081,053902
36081054000,4106,22,1328,897,431,31099,36,081,054000
36081054200,5354,743,1652,1360,292,40981,36,081,054200
36081054500,3670,2840,1319,186,1133,33766,36,081,054500
36081054700,4595,3148,1479,415,1064,37342,36,081,054700
36081054800,2458,127,699,585,114,35666,36,081,054800
36081054900,6285,4222,1664,135,1529,31925,36,081,054900
36081055100,4286,3053,1456,94,1362,43446,36,081,055100
36081055200,2904,370,973,332,641,29167,36,081,055200
36081055300,2791,1444,927,83,844,41625,36,081,055300
36081055400,2674,699,756,403,353,39597,36,081,055400
36081055500,2374,1423,734,217,517,37441,36,081,055500
36081050800,1961,54,680,388,292,37500,36,081,050800
36081055600,2275,358,681,544,137,41169,36,081,055600
36081055700,4109,3410,1308,185,1123,32935,36,081,055700
36081055800,1687,194,538,388,150,36728,36,081,055800
36081055900,1191,708,350,93,257,32102,36,081,055900
36081056000,1704,420,451,381,70,42254,36,081,056000
36081056100,8,0,4,4,0,-666666666,36,081,056100
36081056200,1627,479,530,494,36,40987,36,081,056200
36081056400,1089,335,455,256,199,42250,36,081,056400
36081056500,1575,1113,551,203,348,42146,36,081,056500
36093032300,2729,2308,1179,796,383,37333,36,093,032300
36093032402,3620,3370,1561,808,753,51783,36,093,032402
36093032403,2610,2411,841,670,171,42694,36,093,032403
36093032404,6082,5504,2394,1599,795,37734,36,093,032404
36093032502,2520,2408,845,791,54,41800,36,093,032502
36093032503,4269,4086,1359,1260,99,50313,36,093,032503
36093032504,2501,2381,775,739,36,41250,36,093,032504
36093032601,2435,2242,814,636,178,43815,36,093,032601
36093032602,4365,4035,1633,949,684,41100,36,093,032602
36093032700,3921,3399,1484,1094,390,36750,36,093,032700
36093032901,3584,3136,1305,1141,164,41250,36,093,032901
36093032902,4391,3911,1584,1298,286,50131,36,093,032902
36093033002,2448,2367,790,737,53,50670,36,093,033002
36093033003,3744,2915,1586,1231,355,44981,36,093,033003
36093033004,2565,2369,992,707,285,37451,36,093,033004
36093033101,1836,1785,667,581,86,41278,36,093,033101
36093033102,6534,6102,2241,1835,406,43629,36,093,033102
36093033200,3507,2342,1224,780,444,22066,36,093,033200
36093033300,2334,2124,917,671,246,26847,36,093,033300
36093033400,3033,2437,763,464,299,6150,36,093,033400
36093033500,2386,1868,1308,292,1016,42904,36,093,033500
36095740100,5081,4689,2032,1495,537,39868,36,095,740100
36095740200,5078,4879,2205,1199,1006,39518,36,095,740200
36095740300,1166,774,0,0,0,5376,36,095,740300
36095740400,5191,4920,2055,1652,403,34476,36,095,740400
36095740500,3648,3496,1502,1145,357,34844,36,095,740500
36095740600,2852,2744,1250,1120,130,38871,36,095,740600
36095740700,5407,5160,2423,1831,592,33255,36,095,740700
36095740800,2766,2609,1313,1188,125,28665,36,095,740800
36097950100,4911,4814,2001,1657,344,37083,36,097,950100
36097950200,1767,1647,751,616,135,37778,36,097,950200
36097950300,2879,2785,1129,944,185,29167,36,097,950300
36097950400,3879,3618,1666,1020,646,31050,36,097,950400
36097950500,4409,4340,1855,1300,555,30881,36,097,950500
36099950100,2171,2136,857,755,102,35787,36,099,950100
36099950200,2293,2171,1119,607,512,38556,36,099,950200
36099950300,3833,3462,1778,1361,417,32563,36,099,950300
36099950400,2567,2377,1209,651,558,26327,36,099,950400
36099950500,3686,3328,1590,1014,576,30298,36,099,950500
36099950600,3679,3562,1586,1224,362,32872,36,099,950600
36099950700,3801,3717,1627,1379,248,38315,36,099,950700
36099950801,1395,454,0,0,0,-666666666,36,099,950801
36099950802,4420,3913,1463,1054,409,27201,36,099,950802
36099950900,4533,4050,1708,1266,442,30899,36,099,950900
36099951000,1917,1834,847,700,147,32417,36,099,951000
36119004002,2462,401,1085,149,936,53379,36,119,004002
36119004100,4323,607,1648,1180,468,50825,36,119,004100
36119004200,4589,1305,2176,1568,608,51109,36,119,004200
36119004500,1656,683,771,400,371,59030,36,119,004500
36119004600,2873,2293,1299,937,362,71477,36,119,004600
36119004700,3577,3246,922,832,90,115000,36,119,004700
36119004801,3141,2630,1517,799,718,64559,36,119,004801
36119004802,3407,2013,1417,650,767,45521,36,119,004802
36119004900,3172,2406,1656,1333,323,77083,36,119,004900
36119005001,4107,2940,1423,1028,395,63715,36,119,005001
36119005002,4174,3528,1496,1399,97,79214,36,119,005002
36119005100,3834,3299,1634,931,703,56047,36,119,005100
36119005200,4624,4416,1468,1335,133,90230,36,119,005200
36119005300,5248,3574,1664,1157,507,56552,36,119,005300
36119005400,1709,1249,508,397,111,140625,36,119,005400
36119005500,5535,4537,1872,1722,150,92819,36,119,005500
36119005600,0,0,0,0,0,-666666666,36,119,005600
36119005702,3665,1811,1435,478,957,49208,36,119,005702
36119005703,3255,2425,1404,771,633,50431,36,119,005703
36119005704,3155,1905,1398,649,749,39597,36,119,005704
36119005800,5402,1968,1803,739,1064,30339,36,119,005800
36119005901,5049,2224,1811,651,1160,31439,36,119,005901
36119005902,5883,3410,2445,1088,1357,51899,36,119,005902
36119006000,4245,2447,1663,658,1005,56544,36,119,006000
36119006100,4993,2259,1787,730,1057,35741,36,119,006100
36119006200,5660,2363,2061,673,1388,33588,36,119,006200
36119006301,3501,1709,1276,328,948,30205,36,119,006301
36119006302,2517,609,1295,289,1006,58750,36,119,006302
36119006400,5930,1937,1995,971,1024,37329,36,119,006400
36119006500,4787,2128,1590,957,633,36439,36,119,006500
36119006600,5848,4153,1844,1531,313,32841,36,119,006600
36119006700,5061,4117,1550,1521,29,68770,36,119,006700
36119006801,5099,4319,1636,1543,93,96181,36,119,006801
36119006802,5317,3873,2011,1874,137,92649,36,119,006802
36119006900,6443,5120,2030,1707,323,93984,36,119,006900
36119007000,5511,4548,2237,1874,363,92045,36,119,007000
36119007100,6159,5406,2207,1674,533,93818,36,119,007100
36119007200,6441,5432,2375,1587,788,55417,36,119,007200
36119007300,5072,3322,1611,652,959,43491,36,119,007300
36119007401,4693,3226,1680,982,698,51658,36,119,007401
36119007402,3041,2459,1041,837,204,76800,36,119,007402
36119007500,4772,4162,1690,1169,521,119006,36,119,007500
36119007600,5605,5067,1879,1696,183,92589,36,119,007600
36119007700,5392,3987,1997,1038,959,83419,36,119,007700
36119007800,4865,2690,1360,327,1033,30299,36,119,007800
36059405600,4052,3257,1322,1062,260,58700,36,059,405600
36059405700,4833,3600,1552,1443,109,52282,36,059,405700
36059405800,4254,3699,1305,1187,118,54583,36,059,405800
36059405900,5215,4152,1563,1513,50,58297,36,059,405900
36059406001,5127,3215,1583,1433,150,51538,36,059,406001
36059406002,3317,2371,936,715,221,48600,36,059,406002
36059406100,2697,2021,893,879,14,53508,36,059,406100
36059406201,3431,1235,906,864,42,43775,36,059,406201
36059406202,5727,360,1426,1256,170,46084,36,059,406202
36059406300,3855,3502,1282,1262,20,80740,36,059,406300
36059406400,6568,6312,2534,2206,328,107639,36,059,406400
36059406501,6831,5938,2099,2030,69,86809,36,059,406501
36059406600,4123,3416,1423,1396,27,93393,36,059,406600
36059406701,2496,666,848,492,356,40750,36,059,406701
36059406702,4762,1292,1947,510,1437,31908,36,059,406702
36059406801,4688,633,1433,152,1281,30398,36,059,406801
36059406802,5135,486,1611,272,1339,37654,36,059,406802
36059406900,7755,1342,2053,1136,917,31780,36,059,406900
36059407000,7353,581,2151,827,1324,31935,36,059,407000
36059407101,4701,439,1432,989,443,36474,36,059,407101
36059407102,6849,475,1607,1368,239,40124,36,059,407102
36059407201,4833,642,1404,223,1181,27445,36,059,407201
36059407203,3916,445,1033,614,419,36017,36,059,407203
36059407204,2665,368,771,560,211,34637,36,059,407204
36059407301,7031,4966,1889,1094,795,6606,36,059,407301
36059407302,5217,1862,1432,1089,343,33877,36,059,407302
36059407401,5622,2304,1469,1081,388,36957,36,059,407401
36059407402,3912,835,924,689,235,35909,36,059,407402
36059407501,4936,1800,1310,885,425,30385,36,059,407501
36059407502,5903,995,1600,1303,297,37571,36,059,407502
36059407600,5554,3649,1709,1671,38,51979,36,059,407600
36059407700,5009,3449,1704,1523,181,52882,36,059,407700
36059407801,5551,3668,1779,1596,183,50241,36,059,407801
36059407802,1612,694,289,250,39,20375,36,059,407802
36059407900,6082,4475,2460,1604,856,49970,36,059,407900
36059408000,6116,4542,1915,1778,137,53621,36,059,408000
36059408100,6883,4286,2076,1947,129,52847,36,059,408100
36059408200,6774,5300,2186,2092,94,50182,36,059,408200
36059408300,6874,4701,2384,2146,238,61551,36,059,408300
36059408400,3899,3319,1434,1375,59,67301,36,059,408400
36059408500,6677,5747,1991,1849,142,52482,36,059,408500
36059408600,4396,3309,1385,1235,150,55890,36,059,408600
36059408700,4899,3488,1516,1458,58,48805,36,059,408700
36059408800,6745,5272,2313,2174,139,42112,36,059,408800
36059408900,6004,4889,1888,1772,116,48529,36,059,408900
36059409000,5877,4308,2000,1930,70,50348,36,059,409000
36067010600,2112,1939,993,852,141,45485,36,067,010600
36067010700,1956,1714,920,632,288,43326,36,067,010700
36067010800,4781,4241,1949,1299,650,36272,36,067,010800
36067010900,2374,2241,1020,951,69,37195,36,067,010900
36067011011,3675,3233,1729,1098,631,44609,36,067,011011
36067011012,3890,3344,1779,799,980,41007,36,067,011012
36067011021,2736,2454,1044,803,241,54266,36,067,011021
36067011022,3549,3393,1392,1041,351,43006,36,067,011022
36067011101,5460,4542,2054,1844,210,53133,36,067,011101
36067011102,3514,1951,1699,141,1558,33125,36,067,011102
36067011201,4389,4058,1775,1099,676,31479,36,067,011201
36067011202,4205,3707,1751,1403,348,44988,36,067,011202
36067011231,4442,3959,1786,1628,158,40218,36,067,011231
36067011232,4135,3728,1767,1444,323,59920,36,067,011232
36067011241,2361,2113,902,872,30,61382,36,067,011241
36067011242,6381,5689,2313,2266,47,49153,36,067,011242
36067011300,3509,3155,1586,1115,471,42881,36,067,011300
36067011401,6628,6169,2951,2259,692,56020,36,067,011401
36067011402,4282,4158,1627,1471,156,47138,36,067,011402
36067011500,6195,5763,2383,1922,461,56953,36,067,011500
36067011600,5749,5362,2063,1539,524,50805,36,067,011600
36067011700,4009,3721,1795,922,873,44493,36,067,011700
36067011800,5765,5351,2731,1843,888,34292,36,067,011800
36067011900,3563,3500,1321,1191,130,43224,36,067,011900
36067012000,5733,5302,2328,1995,333,34664,36,067,012000
36067012100,4720,4597,1709,1560,149,57121,36,067,012100
36067012200,979,933,589,321,268,35446,36,067,012200
36067012300,3685,3416,1415,1171,244,42831,36,067,012300
36067012400,4202,4019,1910,1424,486,47214,36,067,012400
36067012500,3497,3115,1533,1087,446,40524,36,067,012500
36067012600,5110,4871,2007,1675,332,38917,36,067,012600
36067012700,2075,1986,935,727,208,35563,36,067,012700
36067012800,2895,2794,1223,1067,156,35625,36,067,012800
36067012900,2395,1610,1011,293,718,28813,36,067,012900
36067013000,3904,3304,1728,1077,651,39396,36,067,013000
36067013100,4548,4109,1776,1683,93,48939,36,067,013100
36067013200,2692,2511,1052,961,91,49116,36,067,013200
36067013300,2182,2038,1078,703,375,42063,36,067,013300
36067013400,5393,4992,2347,1535,812,50225,36,067,013400
36067013500,5212,4761,2516,1710,806,41208,36,067,013500
36067013600,3014,2618,1542,863,679,40619,36,067,013600
36067013701,4175,3681,1974,1475,499,38938,36,067,013701
36067013800,2054,1942,844,687,157,39837,36,067,013800
36067013900,2672,2426,1043,854,189,37338,36,067,013900
36067014000,3575,3264,1378,909,469,28793,36,067,014000
36081056600,1297,191,489,248,241,40774,36,081,056600
36081056700,5406,3723,1532,952,580,41775,36,081,056700
36081056800,5232,505,1601,1068,533,40696,36,081,056800
36081057700,3939,3101,1458,495,963,34105,36,081,057700
36081057900,1690,1126,626,128,498,38340,36,081,057900
36081058000,4248,83,1098,811,287,33495,36,081,058000
36081058100,3068,2414,1123,383,740,39455,36,081,058100
36081058200,5034,169,1411,1179,232,42926,36,081,058200
36081058300,3565,2525,1248,340,908,49898,36,081,058300
36081058500,4501,3697,1601,279,1322,42425,36,081,058500
36081058700,3468,2772,1268,365,903,46352,36,081,058700
36081058900,5147,4386,1734,230,1504,40331,36,081,058900
36081059000,1313,266,400,339,61,41949,36,081,059000
36081059100,5367,3748,2153,429,1724,40265,36,081,059100
36081059200,1575,13,481,430,51,53125,36,081,059200
36081059300,3975,3254,1484,525,959,40747,36,081,059300
36081059400,1787,11,528,495,33,43614,36,081,059400
36081059501,2037,1666,680,186,494,46406,36,081,059501
36081059502,3031,1457,838,268,570,31685,36,081,059502
36081059600,1312,18,524,465,59,33750,36,081,059600
36081059800,1807,26,529,364,165,42155,36,081,059800
36081059900,1198,787,507,326,181,50120,36,081,059900
36081060000,1126,4,360,326,34,51250,36,081,060000
36081060100,2336,1820,805,389,416,60481,36,081,060100
36081060300,2079,1629,662,364,298,47208,36,081,060300
36081060600,1158,7,473,409,64,57794,36,081,060600
36081060701,14,14,14,14,0,-666666666,36,081,060701
36081060800,1568,63,465,388,77,37183,36,081,060800
36081061000,1554,22,437,426,11,47059,36,081,061000
36081061200,2078,0,503,490,13,48750,36,081,061200
36081061301,5446,3843,1835,393,1442,37450,36,081,061301
36081061302,0,0,0,0,0,-666666666,36,081,061302
36081061400,1432,26,410,363,47,49792,36,081,061400
36081061601,2528,110,790,690,100,36806,36,081,061601
36081061602,1047,98,344,278,66,44205,36,081,061602
36081061800,1726,86,661,491,170,52644,36,081,061800
36081061900,3398,2993,1113,426,687,51194,36,081,061900
36081062000,1490,79,482,442,40,53529,36,081,062000
36081062100,2697,1966,993,385,608,41093,36,081,062100
36081062200,2131,177,636,529,107,46146,36,081,062200
36081062300,2266,1999,805,349,456,51815,36,081,062300
36081062400,0,0,0,0,0,-666666666,36,081,062400
36081062500,2484,2146,808,421,387,46934,36,081,062500
36081062600,2622,43,823,742,81,41680,36,081,062600
36081062700,2861,2681,1022,460,562,44521,36,081,062700
36081062900,3156,2101,1009,283,726,45025,36,081,062900
36101960100,1231,1229,534,489,45,34096,36,101,960100
36101960200,3172,2900,1074,938,136,30070,36,101,960200
36101960300,2466,2355,1011,846,165,31918,36,101,960300
36101960400,3936,3605,1611,1212,399,27804,36,101,960400
36101960500,2889,2757,1140,940,200,33116,36,101,960500
36101960600,3998,3772,1739,1354,385,31225,36,101,960600
36101960700,2776,2423,1322,579,743,30206,36,101,960700
36101960800,2910,2760,1225,586,639,26477,36,101,960800
36101960900,2588,2489,1121,636,485,15511,36,101,960900
36101961000,3568,3396,1394,1108,286,32260,36,101,961000
36101961100,4407,4031,1931,1332,599,29983,36,101,961100
36101961200,3566,3292,1821,943,878,23668,36,101,961200
36101961300,3984,3710,1658,1333,325,32250,36,101,961300
36101961400,2154,2064,1020,835,185,32406,36,101,961400
36101961500,1752,1707,761,708,53,30571,36,101,961500
36101961600,1846,1801,676,588,88,32670,36,101,961600
36101961700,3232,3185,1245,1159,86,40124,36,101,961700
36101961800,3224,3067,1218,1016,202,32070,36,101,961800
36101961900,3223,3012,1311,949,362,30240,36,101,961900
36101962000,4359,4273,1590,1278,312,28459,36,101,962000
36101962100,3140,3103,1108,974,134,31938,36,101,962100
36101962200,2579,2548,998,673,325,31084,36,101,962200
36101962301,5634,4787,2130,1552,578,63804,36,101,962301
36101962302,2566,2337,1195,847,348,39121,36,101,962302
36101962400,2847,2726,1363,844,519,37906,36,101,962400
36101962500,2284,2071,1102,536,566,34293,36,101,962500
36101962600,2295,2112,1119,650,469,45806,36,101,962600
36101962700,3216,3025,1607,772,835,33938,36,101,962700
36101962800,3467,3296,1481,1278,203,45069,36,101,962800
36101962900,2747,2606,1180,1000,180,50928,36,101,962900
36101963000,3787,3665,1414,1303,111,40723,36,101,963000
36103110101,3663,3458,1148,1077,71,75441,36,103,110101
36103110103,2187,2157,726,613,113,50991,36,103,110103
36103110104,2864,2280,894,834,60,86513,36,103,110104
36103110200,5262,4660,2287,1936,351,60781,36,103,110200
36103110300,4709,4565,1972,1680,292,73240,36,103,110300
36103110401,2100,2072,876,842,34,77150,36,103,110401
36103110402,3461,3185,1343,1288,55,90662,36,103,110402
36103110501,3054,2854,1100,1031,69,70278,36,103,110501
36103110502,2713,2478,936,847,89,68783,36,103,110502
36103110601,4618,4218,1820,1429,391,66389,36,103,110601
36103110602,2679,2649,1086,946,140,42861,36,103,110602
36103110801,1917,1824,706,643,63,63618,36,103,110801
36103110803,5983,5579,2109,2002,107,73895,36,103,110803
36103110901,2762,2244,1148,790,358,68433,36,103,110901
36119007901,3024,1193,856,135,721,24864,36,119,007901
36119007902,4352,2139,1452,676,776,26323,36,119,007902
36119008000,4610,2143,1473,202,1271,26028,36,119,008000
36119008100,4714,2515,1668,882,786,45015,36,119,008100
36119008200,7613,5267,2411,1578,833,43047,36,119,008200
36119008301,2641,1844,946,669,277,51713,36,119,008301
36119008302,6945,6423,2519,2126,393,50845,36,119,008302
36119008401,2085,1885,687,614,73,108281,36,119,008401
36119008403,4014,3159,1330,677,653,57436,36,119,008403
36119008404,5539,4262,2084,757,1327,56449,36,119,008404
36119008500,3425,3090,1069,1000,69,109000,36,119,008500
36119008602,5462,4176,1235,1142,93,30539,36,119,008602
36119008700,5544,4416,1857,1146,711,46577,36,119,008700
36119008801,1556,591,793,254,539,73553,36,119,008801
36119008802,2425,1535,1398,884,514,72232,36,119,008802
36119008901,6263,3811,2747,1431,1316,54219,36,119,008901
36119008902,3811,2033,1390,471,919,36714,36,119,008902
36119009000,3951,1898,1551,662,889,52429,36,119,009000
36119009100,5802,1940,2046,790,1256,32414,36,119,009100
36119009201,4017,1750,1268,469,799,32157,36,119,009201
36119009202,3139,1050,1066,401,665,26214,36,119,009202
36119009300,3239,1114,1556,408,1148,33360,36,119,009300
36119009400,3662,1909,1573,472,1101,36997,36,119,009400
36119009500,5779,3411,2382,982,1400,52818,36,119,009500
36119009600,4514,3617,1669,1543,126,75039,36,119,009600
36119009701,3107,2290,1156,1004,152,81115,36,119,009701
36119009702,2836,2494,1188,957,231,75455,36,119,009702
36119009703,4070,3586,1439,1359,80,57059,36,119,009703
36119009800,4611,3405,1432,1203,229,159922,36,119,009800
36119009900,2826,2097,820,788,32,159083,36,119,009900
36119010000,5597,4517,1739,1646,93,151518,36,119,010000
36119010100,4856,3351,1463,1085,378,108667,36,119,010100
36119010200,4734,4210,1572,1479,93,82560,36,119,010200
36119010300,3235,2967,1410,800,610,75313,36,119,010300
36119010400,4184,3362,1347,639,708,52685,36,119,010400
36119010500,6775,5177,2295,1465,830,70649,36,119,010500
36119010600,4533,3202,1623,1214,409,96236,36,119,010600
36119010701,6023,4173,1880,1820,60,107737,36,119,010701
36119010702,5184,3747,2223,1673,550,73226,36,119,010702
36119010801,3414,2551,1298,1107,191,65313,36,119,010801
36119010803,3645,2411,1939,1700,239,68854,36,119,010803
36119010804,2427,1541,1018,863,155,73438,36,119,010804
36119010901,2144,1172,699,498,201,48672,36,119,010901
36119010902,6054,2522,2191,1624,567,51518,36,119,010902
36119010903,4965,1450,1719,882,837,45685,36,119,010903
36059409100,4927,3415,1814,1738,76,48468,36,059,409100
36059409200,5886,4678,1923,1674,249,60879,36,059,409200
36059409300,4142,3768,1362,1323,39,47434,36,059,409300
36059409400,4369,3983,1384,1340,44,54696,36,059,409400
36059409500,4021,3857,1293,1249,44,60143,36,059,409500
36059409600,5190,4640,1703,1679,24,61923,36,059,409600
36059409700,4188,3889,1605,1479,126,76781,36,059,409700
36059409800,5880,470,1495,1349,146,48239,36,059,409800
36059409900,8442,1940,2646,2195,451,51250,36,059,409900
36059410000,4390,1580,1434,1340,94,62978,36,059,410000
36059410100,5825,4941,2043,2014,29,66841,36,059,410100
36059410200,3662,3028,1414,1296,118,57738,36,059,410200
36059410300,6642,1579,1903,1711,192,42387,36,059,410300
36059410400,4671,1092,1281,1167,114,42691,36,059,410400
36059410500,7183,2549,2677,1771,906,47587,36,059,410500
36059410600,7205,3512,2285,2128,157,48634,36,059,410600
36059410700,7159,2501,2252,1614,638,51559,36,059,410700
36059410800,4629,2210,1459,1338,121,54943,36,059,410800
36059410900,6519,2622,2087,1676,411,52969,36,059,410900
36059411000,5425,2925,1630,1073,557,31027,36,059,411000
36059411100,4379,1209,1417,400,1017,30419,36,059,411100
36059411200,6642,5656,2362,1445,917,51240,36,059,411200
36059411301,3813,3231,1236,1080,156,75398,36,059,411301
36059411302,6657,6408,2047,1956,91,63868,36,059,411302
36059411400,6550,5265,1752,1516,236,56181,36,059,411400
36059411500,2750,2392,893,878,15,108043,36,059,411500
36059411600,6517,6385,1878,1574,304,78194,36,059,411600
36059411700,7064,5045,2409,1871,538,59492,36,059,411700
36059411800,6163,5749,2291,1675,616,61848,36,059,411800
36059411901,3441,2521,1443,846,597,46791,36,059,411901
36059411902,4039,2594,1233,1040,193,65101,36,059,411902
36059412000,5802,4007,2026,1525,501,53964,36,059,412000
36059412100,6263,5041,2552,1812,740,53705,36,059,412100
36059412200,4905,3751,1934,1301,633,51241,36,059,412200
36059412301,3281,2860,1658,1029,629,56806,36,059,412301
36059412302,3629,3105,1271,973,298,60625,36,059,412302
36059412400,5842,3998,3068,1448,1620,65202,36,059,412400
36059412500,3855,3788,1252,1232,20,87017,36,059,412500
36059412600,3786,3580,1164,1164,0,87426,36,059,412600
36059412700,4159,3462,1379,1336,43,84306,36,059,412700
36059412800,3157,2028,1092,1004,88,67907,36,059,412800
36059412900,6143,1285,1908,1600,308,51786,36,059,412900
36059413001,3469,3161,1313,991,322,51372,36,059,413001
36059413002,4010,3566,1345,1163,182,58039,36,059,413002
36059413100,5183,4210,1761,1604,157,61070,36,059,413100
36059413200,5720,4838,2278,1998,280,60660,36,059,413200
36067014200,4176,3593,1842,1258,584,30603,36,067,014200
36067014300,2938,2814,1430,641,789,33248,36,067,014300
36067014400,2381,1799,987,703,284,35156,36,067,014400
36067014500,3523,3238,1855,1171,684,40884,36,067,014500
36067014600,4615,3107,1465,897,568,25882,36,067,014600
36067014700,5916,4540,2478,1804,674,61138,36,067,014700
36067014800,3334,3047,1198,1120,78,60169,36,067,014800
36067014900,2365,1789,590,505,85,37500,36,067,014900
36067015000,4275,3718,1762,1445,317,60475,36,067,015000
36067015100,5765,5363,2604,1687,917,44450,36,067,015100
36067015201,3217,2792,1356,883,473,51990,36,067,015201
36067015202,4427,3753,1587,1340,247,58966,36,067,015202
36067015203,2713,2503,1102,821,281,49744,36,067,015203
36067015400,5193,4518,2090,1719,371,40879,36,067,015400
36067015500,2824,2782,1177,1043,134,42230,36,067,015500
36067015601,1982,1958,716,645,71,41534,36,067,015601
36067015602,1391,1391,572,532,40,60938,36,067,015602
36067015701,2481,2408,1099,1045,54,50853,36,067,015701
36067015702,4805,4122,1586,1566,20,62478,36,067,015702
36067015800,4823,4429,1928,1728,200,41176,36,067,015800
36067016001,3150,2975,1325,1281,44,42857,36,067,016001
36067016002,2819,2622,1122,1110,12,52367,36,067,016002
36067016100,2486,1826,807,653,154,53185,36,067,016100
36067016200,2299,1551,889,794,95,33567,36,067,016200
36067016300,7419,6328,2746,2131,615,41421,36,067,016300
36067016400,4098,3886,1607,1074,533,40194,36,067,016400
36067016501,1746,1648,689,642,47,34116,36,067,016501
36067016502,4316,4178,1846,1313,533,41223,36,067,016502
36067016600,4745,4633,2007,1575,432,54082,36,067,016600
36067016700,2446,2436,1049,919,130,52862,36,067,016700
36067016801,1835,1783,800,771,29,48057,36,067,016801
36067016802,2533,2455,982,805,177,43063,36,067,016802
36067016901,2679,2604,1087,867,220,48924,36,067,016901
36067016902,2205,2114,853,756,97,37614,36,067,016902
36067940000,40,3,34,34,0,-666666666,36,067,940000
36069050101,3123,2885,1228,1026,202,67688,36,069,050101
36069050103,3107,2905,1526,1124,402,46658,36,069,050103
36069050104,3588,3062,1221,1112,109,67286,36,069,050104
36069050105,3571,3397,1440,1113,327,42857,36,069,050105
36069050106,1592,1592,576,576,0,72232,36,069,050106
36069050203,3797,3318,1711,872,839,39202,36,069,050203
36069050204,3203,3112,1286,1176,110,43750,36,069,050204
36069050205,4402,4031,1705,1196,509,36406,36,069,050205
36069050206,2041,1837,704,573,131,41534,36,069,050206
36069050302,4209,4123,1651,1305,346,35082,36,069,050302
36081063200,2441,68,711,615,96,39617,36,081,063200
36081063301,1608,1348,533,273,260,52619,36,081,063301
36081063302,1527,1183,542,315,227,44107,36,081,063302
36081063500,2521,2087,909,526,383,52634,36,081,063500
36081063700,3367,2892,1145,943,202,53804,36,081,063700
36081063800,3358,199,1016,884,132,42930,36,081,063800
36081063900,2978,1911,1033,594,439,41359,36,081,063900
36081064101,2288,1595,923,828,95,47179,36,081,064101
36081064102,0,0,0,0,0,-666666666,36,081,064102
36081064500,1876,964,711,411,300,54297,36,081,064500
36081064600,3156,51,1057,922,135,40373,36,081,064600
36081065000,2801,73,826,710,116,53402,36,081,065000
36081065401,3728,367,974,603,371,41444,36,081,065401
36081065402,27,6,6,6,0,-666666666,36,081,065402
36081065501,0,0,0,0,0,-666666666,36,081,065501
36081065600,4896,548,1474,864,610,43092,36,081,065600
36081065702,1491,1219,610,315,295,44567,36,081,065702
36081065703,3020,2185,1124,758,366,35943,36,081,065703
36081065900,1941,1610,660,544,116,50000,36,081,065900
36081066000,3403,128,1153,822,331,41890,36,081,066000
36081066100,1638,1578,612,514,98,58804,36,081,066100
36081066301,2842,2086,1025,899,126,53542,36,081,066301
36081066302,0,0,0,0,0,-666666666,36,081,066302
36081066401,1444,272,378,274,104,41406,36,081,066401
36081066402,2941,262,1017,730,287,50379,36,081,066402
36081066403,5708,173,1526,666,860,41648,36,081,066403
36081066404,0,0,0,0,0,-666666666,36,081,066404
36081066501,3948,3204,1486,870,616,54316,36,081,066501
36081066701,3047,2226,994,663,331,60155,36,081,066701
36081066900,1687,1470,577,288,289,50689,36,081,066900
36081067100,2516,1577,951,871,80,61614,36,081,067100
36081067700,1820,1535,648,516,132,69148,36,081,067700
36081067900,4325,2395,1643,419,1224,41573,36,081,067900
36081068000,5212,20,1551,1158,393,44318,36,081,068000
36081068200,974,21,355,271,84,56050,36,081,068200
36081068300,3992,773,1670,820,850,38095,36,081,068300
36081063000,1476,24,518,470,48,56604,36,081,063000
36081068700,4002,1898,1906,821,1085,40168,36,081,068700
36081069000,3746,173,978,602,376,37467,36,081,069000
36081069300,2791,1024,1161,249,912,43897,36,081,069300
36081069400,3352,213,1116,548,568,42882,36,081,069400
36081069500,2247,1145,858,450,408,51208,36,081,069500
36081069701,4071,1881,1766,266,1500,56199,36,081,069701
36081069702,3637,2070,1341,950,391,62377,36,081,069702
36081070300,2129,868,884,613,271,35104,36,081,070300
36081070700,2535,1470,1003,771,232,69340,36,081,070700
36103110902,4270,2791,1496,1023,473,48750,36,103,110902
36103111001,2255,1775,996,827,169,69929,36,103,111001
36103111002,4735,3072,1697,982,715,37118,36,103,111002
36103111101,2715,1421,706,541,165,42397,36,103,111101
36103111102,2645,893,684,441,243,30362,36,103,111102
36103111103,3417,1237,1129,808,321,37276,36,103,111103
36103111201,3259,2198,1019,701,318,39142,36,103,111201
36103111202,5671,4608,1897,1464,433,43717,36,103,111202
36103111300,4363,4128,1492,1411,81,57292,36,103,111300
36103111401,1495,1234,541,520,21,55208,36,103,111401
36103111402,5302,4645,1755,1636,119,65687,36,103,111402
36103111503,4806,3122,1654,1206,448,41787,36,103,111503
36103111504,1935,1491,574,567,7,81382,36,103,111504
36103111506,3006,1867,851,851,0,64252,36,103,111506
36103111507,2725,1146,704,581,123,31790,36,103,111507
36103111508,4429,3482,1192,1082,110,48190,36,103,111508
36103111601,3973,3853,1413,1218,195,52568,36,103,111601
36103111602,2791,2720,1199,1133,66,49219,36,103,111602
36103111701,5788,5065,2155,1674,481,69639,36,103,111701
36103111703,3051,2639,961,826,135,47222,36,103,111703
36103111704,3740,3584,1195,1171,24,71250,36,103,111704
36103111801,6566,5679,2146,2066,80,52273,36,103,111801
36103111802,2722,2446,875,847,28,65625,36,103,111802
36103111803,2864,2551,855,811,44,61250,36,103,111803
36103111804,2318,2121,741,705,36,54010,36,103,111804
36103111900,5225,4842,1896,1819,77,64643,36,103,111900
36103112001,4768,3915,1606,1440,166,56616,36,103,112001
36103112002,5418,4871,1851,1593,258,52813,36,103,112002
36103112102,3365,2838,1131,1124,7,90288,36,103,112102
36103112103,4994,4553,1591,1372,219,65082,36,103,112103
36103112104,2007,1506,658,630,28,70455,36,103,112104
36103112204,3837,3028,1214,1122,92,63405,36,103,112204
36103112211,3961,3228,1258,1199,59,62625,36,103,112211
36103112212,3503,2660,1082,1082,0,91891,36,103,112212
36103112213,4801,3240,1509,1429,80,57903,36,103,112213
36103112215,2871,2601,1331,827,504,63147,36,103,112215
36103112216,3908,2924,1193,1145,48,70404,36,103,112216
36103112217,2450,2206,1078,1078,0,122708,36,103,112217
36103112218,4977,4305,1896,1777,119,51815,36,103,112218
36103112219,2788,2262,1421,1205,216,23155,36,103,112219
36103112220,3519,3028,1021,980,41,70344,36,103,112220
36103122300,3985,2873,1180,915,265,52741,36,103,122300
36103122405,3472,789,845,810,35,44984,36,103,122405
36103122406,5431,583,1650,1245,405,40675,36,103,122406
36103122407,1758,677,599,537,62,54667,36,103,122407
36119011101,6029,3633,2471,1161,1310,72455,36,119,011101
36119011102,2807,1836,977,889,88,84531,36,119,011102
36119011200,4531,1696,1186,794,392,32473,36,119,011200
36119011300,6494,5347,2141,1671,470,70309,36,119,011300
36119011401,3822,3121,1796,1382,414,82054,36,119,011401
36119011402,1760,1115,630,501,129,101867,36,119,011402
36119011500,5812,4052,2256,969,1287,51031,36,119,011500
36119011601,3093,846,1240,128,1112,24500,36,119,011601
36119011602,3494,1582,1388,313,1075,29903,36,119,011602
36119011700,3428,2759,1285,971,314,72415,36,119,011700
36119011800,5640,4611,1646,1503,143,57016,36,119,011800
36119011902,4752,3840,1562,1218,344,51930,36,119,011902
36119012000,4656,4052,1635,1413,222,63302,36,119,012000
36119012101,5499,4937,1789,1729,60,73725,36,119,012101
36119012102,4883,4367,1521,1252,269,64389,36,119,012102
36119012201,3147,2479,1043,1022,21,67059,36,119,012201
36119012202,4109,3376,1313,952,361,56528,36,119,012202
36119012301,2585,1865,884,561,323,50925,36,119,012301
36119012303,4836,3582,1661,1493,168,78304,36,119,012303
36119012304,4802,4498,1749,1684,65,111739,36,119,012304
36119012400,5117,4618,1847,1682,165,79157,36,119,012400
36119012501,3252,2805,1109,985,124,78600,36,119,012501
36119012502,5528,5070,2059,1982,77,75389,36,119,012502
36119012503,3772,3439,1430,1213,217,54781,36,119,012503
36119012600,4632,4122,1498,1155,343,75238,36,119,012600
36119012700,4578,3877,1507,1347,160,67849,36,119,012700
36119012803,2597,2243,1059,799,260,81395,36,119,012803
36119012804,4624,2928,1582,836,746,45827,36,119,012804
36119012900,4344,2959,1799,995,804,35589,36,119,012900
36119013000,6605,5278,2368,1674,694,53429,36,119,013000
36119013102,6646,5595,2399,2068,331,110189,36,119,013102
36119013103,5693,4847,1768,1667,101,67399,36,119,013103
36119013104,5487,4573,1753,1690,63,88966,36,119,013104
36119013201,3921,3211,1264,1233,31,105400,36,119,013201
36119013202,3210,2860,1286,890,396,82934,36,119,013202
36119013301,3623,1870,1373,417,956,32093,36,119,013301
36119011000,2774,753,868,656,212,48274,36,119,011000
36119013304,4774,1797,1735,1139,596,34712,36,119,013304
36119013401,2453,1095,1268,590,678,62624,36,119,013401
36119013402,4137,2397,1603,801,802,39000,36,119,013402
36119013500,3899,3177,1405,953,452,45833,36,119,013500
36119013600,4335,2462,1757,903,854,32750,36,119,013600
36119013700,5554,4382,2155,1977,178,71908,36,119,013700
36119013800,3379,3043,1174,1018,156,66458,36,119,013800
36059413300,6122,5671,2147,2046,101,53958,36,059,413300
36059413400,5346,4983,1763,1675,88,55455,36,059,413400
36059413500,7451,3013,2440,2170,270,52356,36,059,413500
36059413600,6065,3320,1952,1502,450,55640,36,059,413600
36059413700,5271,2960,1631,1359,272,56287,36,059,413700
36059413803,4138,1875,1458,1385,73,54101,36,059,413803
36059413804,3871,2146,1329,1253,76,54554,36,059,413804
36059413900,7553,1438,1865,1362,503,40170,36,059,413900
36059414001,4355,956,1222,795,427,40886,36,059,414001
36059414002,4614,630,1191,876,315,32108,36,059,414002
36059414100,6829,1655,2002,1733,269,34731,36,059,414100
36059414201,5336,1924,2074,939,1135,38887,36,059,414201
36059414202,3914,1078,1142,745,397,29353,36,059,414202
36059414301,3852,1558,1142,567,575,33420,36,059,414301
36059414303,5278,2290,1489,1135,354,35612,36,059,414303
36059414304,3121,1212,1084,392,692,30660,36,059,414304
36059414400,5107,1829,1630,741,889,28816,36,059,414400
36059414501,5728,3598,2041,1849,192,63925,36,059,414501
36059414502,3828,2570,1741,1495,246,51211,36,059,414502
36059414600,3636,3238,1095,1077,18,65493,36,059,414600
36059414700,4502,4187,1513,1412,101,55636,36,059,414700
36059414800,7065,6330,2145,1828,317,57399,36,059,414800
36059414900,7680,5493,2284,2129,155,64639,36,059,414900
36059415000,5645,5271,1893,1768,125,73667,36,059,415000
36059415101,2419,2099,911,900,11,54669,36,059,415101
36059415102,5061,4822,1706,1665,41,97295,36,059,415102
36059415201,3266,2877,1142,1068,74,64797,36,059,415201
36059415202,4203,4017,1480,1430,50,87981,36,059,415202
36059415300,6360,5537,2051,1662,389,59360,36,059,415300
36059415401,5147,4840,1758,1616,142,59538,36,059,415401
36059415402,4380,4134,1428,1376,52,75250,36,059,415402
36059415500,2414,2257,836,798,38,72067,36,059,415500
36059415600,5460,5154,1742,1689,53,61969,36,059,415600
36059415700,5961,5631,1934,1820,114,71000,36,059,415700
36059415802,6127,5883,2115,1984,131,61542,36,059,415802
36059416000,4209,4134,1331,1244,87,70918,36,059,416000
36059416100,6209,5963,2132,1986,146,60198,36,059,416100
36059416201,3600,3032,1295,1093,202,53321,36,059,416201
36059416202,4835,3819,1532,868,664,42285,36,059,416202
36059416300,3208,3049,1261,1085,176,58450,36,059,416300
36059416401,4463,4314,1923,1151,772,52219,36,059,416401
36059416402,2668,2383,934,695,239,74348,36,059,416402
36059416500,6259,3404,1987,1117,870,43750,36,059,416500
36059416600,5382,4442,2427,1422,1005,53952,36,059,416600
36059416701,4686,3762,1588,1021,567,55869,36,059,416701
36059416702,3997,3190,2248,1111,1137,70768,36,059,416702
36069050303,2298,2120,929,645,284,27064,36,069,050303
36069050304,2687,2601,1085,979,106,43356,36,069,050304
36069050401,3541,3253,1423,1235,188,40544,36,069,050401
36069050402,3290,2973,1342,1073,269,34261,36,069,050402
36069050501,3559,3468,1491,1126,365,29444,36,069,050501
36069050502,2378,2289,1036,961,75,39826,36,069,050502
36069050601,6268,6172,2668,2121,547,60313,36,069,050601
36069050603,2463,2232,978,516,462,42373,36,069,050603
36069050604,2522,2416,1148,774,374,36952,36,069,050604
36069050800,3057,2973,1397,510,887,26215,36,069,050800
36069050900,2190,1996,1152,759,393,39817,36,069,050900
36069051001,1798,1652,817,353,464,36705,36,069,051001
36069051101,1874,1552,806,356,450,26250,36,069,051101
36069051102,1322,1296,756,428,328,36803,36,069,051102
36069051200,3667,3398,1387,1240,147,30808,36,069,051200
36069051301,1779,1770,669,621,48,47965,36,069,051301
36069051302,2422,2358,1054,831,223,27708,36,069,051302
36069051400,2695,2660,1069,945,124,36127,36,069,051400
36069051501,2052,1721,996,822,174,48675,36,069,051501
36069051502,1255,1053,652,439,213,21941,36,069,051502
36069051600,1382,1333,743,579,164,32150,36,069,051600
36069051700,2804,1947,1137,540,597,26484,36,069,051700
36069051801,5192,3983,2438,774,1664,26714,36,069,051801
36069051900,3342,2626,577,346,231,4188,36,069,051900
36069052001,1632,1610,749,636,113,33696,36,069,052001
36069052002,1667,1471,657,621,36,40938,36,069,052002
36069052003,1589,1539,720,465,255,37150,36,069,052003
36069052101,1705,1659,785,723,62,42337,36,069,052101
36069052102,2232,2182,1021,969,52,34487,36,069,052102
36069052200,2479,2399,981,777,204,27860,36,069,052200
36071000100,3060,1710,1196,525,671,20120,36,071,000100
36071000200,3012,1624,1004,607,397,37391,36,071,000200
36071000301,1785,531,546,55,491,30661,36,071,000301
36071000302,4685,1505,1482,727,755,36713,36,071,000302
36071000400,4529,1360,1916,432,1484,28387,36,071,000400
36071000501,2895,1156,1083,221,862,31073,36,071,000501
36071000502,4055,1606,1239,310,929,32102,36,071,000502
36071000600,4125,1757,1802,422,1380,30257,36,071,000600
36071001100,4244,2316,1398,665,733,30621,36,071,001100
36071001200,2225,896,668,317,351,30092,36,071,001200
36071001300,3106,2152,1209,1042,167,53819,36,071,001300
36071001500,4628,2900,1813,896,917,32229,36,071,001500
36071001601,4213,1660,1761,855,906,39388,36,071,001601
36071001602,3549,2150,882,712,170,29077,36,071,001602
36071002100,3533,2663,1513,921,592,26718,36,071,002100
36071002200,2554,2320,1504,520,984,24659,36,071,002200
36081070900,2992,1380,1071,568,503,60609,36,081,070900
36081071100,6162,3977,2903,1769,1134,68020,36,081,071100
36081071303,5396,3461,2606,836,1770,60431,36,081,071303
36081071304,5743,3596,2831,1237,1594,61096,36,081,071304
36081071305,5195,3049,2419,446,1973,76758,36,081,071305
36081071306,6678,3240,2966,862,2104,54825,36,081,071306
36081071600,0,0,0,0,0,-666666666,36,081,071600
36081071701,4844,2992,2332,1156,1176,59139,36,081,071701
36081071702,4022,1322,1925,1077,848,54592,36,081,071702
36081071900,2525,1244,1016,357,659,45750,36,081,071900
36081072100,4475,2293,2104,1208,896,64145,36,081,072100
36081072300,2043,1203,795,712,83,102419,36,081,072300
36081072900,1341,679,495,430,65,61116,36,081,072900
36081073100,1535,1085,530,378,152,51821,36,081,073100
36081073700,2052,1333,1046,452,594,72986,36,081,073700
36081073900,5530,3211,2637,1242,1395,85078,36,081,073900
36081074100,3057,1857,1597,983,614,63980,36,081,074100
36081074300,4081,2449,1773,827,946,41296,36,081,074300
36081074500,4104,2547,1538,339,1199,45446,36,081,074500
36081074700,3363,1138,1232,682,550,41146,36,081,074700
36081074900,1440,954,502,371,131,99615,36,081,074900
36081075701,4695,2491,2413,1484,929,96983,36,081,075701
36081075702,5409,3084,2331,1693,638,63694,36,081,075702
36081076901,4081,2408,2178,1157,1021,68506,36,081,076901
36081076902,1158,573,581,129,452,65000,36,081,076902
36081077300,2049,1404,1024,621,403,66029,36,081,077300
36081077500,2213,1785,987,282,705,59241,36,081,077500
36081077902,4640,3815,1519,1050,469,56681,36,081,077902
36081077903,3234,1876,1126,554,572,52278,36,081,077903
36081077904,5783,3408,1972,1007,965,52759,36,081,077904
36081077905,2873,970,1237,952,285,38882,36,081,077905
36081077906,3562,2240,1257,761,496,33246,36,081,077906
36081077907,3761,2823,967,227,740,33312,36,081,077907
36081077908,3048,760,1064,59,1005,32730,36,081,077908
36081078800,1935,87,522,403,119,40848,36,081,078800
36081079000,2527,55,730,351,379,39958,36,081,079000
36081079200,2488,63,785,536,249,43023,36,081,079200
36081079300,0,0,0,0,0,-666666666,36,081,079300
36081079701,6669,464,2722,584,2138,31638,36,081,079701
36081079702,4259,401,1415,380,1035,24083,36,081,079702
36081079900,3215,571,964,306,658,22062,36,081,079900
36081080301,3804,395,1049,431,618,26723,36,081,080301
36081080302,3323,843,1038,460,578,36855,36,081,080302
36081080900,7018,3363,2564,1661,903,41226,36,081,080900
36081081400,4488,406,1026,736,290,41263,36,081,081400
36081081800,4084,516,1033,617,416,40159,36,081,081800
36103122408,3680,2809,1072,944,128,47655,36,103,122408
36103122501,5440,788,1466,805,661,30487,36,103,122501
36103122502,4656,730,1068,994,74,37641,36,103,122502
36103122602,4254,3295,1359,1273,86,52862,36,103,122602
36103122603,5586,4155,1684,1327,357,50410,36,103,122603
36103122604,3813,2715,1101,1007,94,55067,36,103,122604
36103122605,2155,1162,637,496,141,50445,36,103,122605
36103122704,2529,1463,831,704,127,60375,36,103,122704
36103122705,3038,2127,974,881,93,54414,36,103,122705
36103122706,3633,2490,1205,873,332,54500,36,103,122706
36103122707,2768,2431,950,903,47,52818,36,103,122707
36103122801,4614,2710,1715,1195,520,39389,36,103,122801
36103122802,4842,3299,1564,1270,294,52957,36,103,122802
36103122901,6506,5592,1826,1545,281,51553,36,103,122901
36103122902,4136,3821,1410,1030,380,41939,36,103,122902
36103123001,5742,4368,1664,1471,193,47464,36,103,123001
36103123002,4530,3516,1445,1243,202,45354,36,103,123002
36103123101,3416,3018,1115,1036,79,45045,36,103,123101
36103123102,4028,3263,1292,1114,178,50244,36,103,123102
36103123201,2089,1122,660,339,321,40938,36,103,123201
36103123203,2952,473,890,587,303,47147,36,103,123203
36103123204,5816,1089,1775,1020,755,36114,36,103,123204
36103123303,5008,608,1273,881,392,32454,36,103,123303
36103123304,5357,925,1562,1041,521,37878,36,103,123304
36103123401,3651,2884,1221,972,249,41755,36,103,123401
36103123403,1507,1311,503,372,131,52903,36,103,123403
36103123404,5459,4264,1853,1396,457,48688,36,103,123404
36103123500,6432,4551,2091,1224,867,42319,36,103,123500
36103123600,3047,2986,1336,1183,153,56037,36,103,123600
36103123701,7561,3571,1842,1244,598,34118,36,103,123701
36103123703,3314,1898,1041,829,212,42108,36,103,123703
36103123704,4680,2589,1291,1016,275,30093,36,103,123704
36103123801,4120,3534,1591,1362,229,50000,36,103,123801
36103123802,3525,2726,1177,1003,174,60027,36,103,123802
36103123900,5521,4269,1690,1446,244,41446,36,103,123900
36103124001,4540,3953,1457,1331,126,50476,36,103,124001
36103124002,3376,2612,991,917,74,43991,36,103,124002
36103124101,4315,3697,1453,1197,256,51755,36,103,124101
36103124102,3591,3002,1155,976,179,46250,36,103,124102
36103124200,5542,4742,1981,1469,512,42981,36,103,124200
36103124301,2088,1926,748,441,307,62556,36,103,124301
36103124302,4390,3770,1854,1161,693,54344,36,103,124302
36103124401,3390,3163,1357,602,755,59107,36,103,124401
36103124402,3727,3454,1321,1268,53,55318,36,103,124402
36103124500,5162,4634,1884,1538,346,70008,36,103,124500
36119013900,4742,3863,1767,1289,478,56090,36,119,013900
36119014000,2274,1593,752,592,160,42028,36,119,014000
36119014100,6593,3120,2919,1120,1799,40406,36,119,014100
36119014200,3493,1322,1283,571,712,26907,36,119,014200
36119014300,4141,611,1363,221,1142,26689,36,119,014300
36119014400,6264,2062,2204,1417,787,35900,36,119,014400
36119014500,3620,2371,1910,1472,438,53621,36,119,014500
36119014604,4408,3630,1553,1159,394,42083,36,119,014604
36119014605,3253,2165,1520,485,1035,52906,36,119,014605
36119014606,5461,4976,1758,1662,96,53632,36,119,014606
36119014607,4694,3319,1382,1290,92,50060,36,119,014607
36119014701,5146,3407,1754,1473,281,39397,36,119,014701
36119014703,6096,4183,1989,1646,343,55503,36,119,014703
36119014704,2368,1564,776,523,253,37047,36,119,014704
36119014805,4222,3220,1453,1315,138,82045,36,119,014805
36119014806,6066,5229,2234,2122,112,87353,36,119,014806
36119014808,3457,3165,1113,1002,111,68214,36,119,014808
36119014809,6088,4317,2343,1900,443,45208,36,119,014809
36119014810,1967,1920,1122,986,136,52194,36,119,014810
36119014811,5753,4779,1790,1761,29,57131,36,119,014811
36119014812,4771,4086,1704,1139,565,47225,36,119,014812
36119014813,4104,2891,1514,884,630,44923,36,119,014813
36119014901,6796,5408,2075,1983,92,80526,36,119,014901
36119014903,4065,3954,2154,1938,216,73182,36,119,014903
36119014907,4220,3451,1448,1321,127,64069,36,119,014907
36119014908,3844,3540,1372,940,432,81849,36,119,014908
36119014909,2635,2608,1222,1047,175,65037,36,119,014909
36119015000,5149,4174,1771,1480,291,71194,36,119,015000
36119015100,4911,2792,1648,1184,464,50460,36,119,015100
36119981000,2187,728,332,0,332,11650,36,119,981000
36119982000,1745,463,0,0,0,11989,36,119,982000
36119983000,1231,484,0,0,0,7813,36,119,983000
36119984000,564,325,161,17,144,27917,36,119,984000
36119985000,2294,1470,0,0,0,2938,36,119,985000
36121970100,2574,2413,1085,919,166,40220,36,121,970100
36121970201,2201,762,0,0,0,-666666666,36,121,970201
36121970202,4789,4658,2007,1473,534,32376,36,121,970202
36121970300,3221,3221,1295,1234,61,42206,36,121,970300
36121970400,3724,3427,1515,1322,193,36935,36,121,970400
36121970500,4817,4485,2215,1285,930,35714,36,121,970500
36121970600,4372,3745,1704,1139,565,31929,36,121,970600
36121970700,2788,2657,1206,1038,168,29669,36,121,970700
36121970800,2740,2650,1187,893,294,33480,36,121,970800
36121970900,2106,2101,837,716,121,40975,36,121,970900
36121971000,4103,4012,2011,1439,572,32558,36,121,971000
36059416801,2139,2112,780,688,92,51446,36,059,416801
36059416802,3881,3314,2123,1234,889,61647,36,059,416802
36059416900,4046,3921,1723,1320,403,66875,36,059,416900
36059517000,3757,3027,1330,1133,197,38964,36,059,517000
36059517101,5121,3496,1942,1013,929,40962,36,059,517101
36059517102,2527,1851,825,797,28,52865,36,059,517102
36059517201,3457,1550,1665,230,1435,25500,36,059,517201
36059517202,3414,1683,1395,754,641,44276,36,059,517202
36059517301,3529,2345,1211,692,519,41173,36,059,517301
36059517302,5367,3974,1833,912,921,35689,36,059,517302
36059517400,5045,4692,1847,1540,307,60528,36,059,517400
36059517500,3783,3379,1475,1399,76,52555,36,059,517500
36059517600,4843,4478,1697,1421,276,51964,36,059,517600
36059517701,7493,5101,2412,2160,252,71282,36,059,517701
36059517705,3051,2308,1025,922,103,107333,36,059,517705
36059517801,3980,3656,1303,1184,119,73348,36,059,517801
36059517802,3485,3169,1228,939,289,64019,36,059,517802
36059517901,4814,4484,1758,1561,197,67891,36,059,517901
36059517902,2863,2729,1190,996,194,53099,36,059,517902
36059518000,6167,5544,2643,1386,1257,58019,36,059,518000
36059518100,2913,2560,988,936,52,80000,36,059,518100
36059518201,4185,3446,1358,1255,103,79145,36,059,518201
36059518203,4348,3388,1256,1036,220,84400,36,059,518203
36059518204,4553,3720,1813,1681,132,120814,36,059,518204
36059518300,6029,3773,1970,1623,347,79766,36,059,518300
36059518400,4338,3038,1408,1341,67,64762,36,059,518400
36059518501,6935,3977,2296,2020,276,66891,36,059,518501
36059518502,2960,1523,1112,722,390,61146,36,059,518502
36059518600,4201,2651,1346,1325,21,75500,36,059,518600
36059518700,5687,3671,1779,1736,43,83482,36,059,518700
36059518800,3200,2253,1029,1002,27,79583,36,059,518800
36059518900,7113,2985,2014,1694,320,45843,36,059,518900
36059519000,6462,3583,1997,1802,195,47083,36,059,519000
36059519100,5587,3222,2151,1896,255,47333,36,059,519100
36059519200,6285,3386,1926,1769,157,50898,36,059,519200
36059519300,6298,3161,1894,1370,524,42254,36,059,519300
36059519400,4486,3295,1503,1408,95,54177,36,059,519400
36059519500,6237,3955,1955,1831,124,49498,36,059,519500
36059519601,4366,3546,1484,1466,18,61458,36,059,519601
36059519602,1797,1404,654,643,11,75509,36,059,519602
36059519702,5806,4271,2094,1793,301,85342,36,059,519702
36059519703,3453,2536,1093,1061,32,63173,36,059,519703
36059519704,3124,2291,1100,917,183,60329,36,059,519704
36059519801,2475,2057,826,695,131,59911,36,059,519801
36059519802,5246,4431,1685,1510,175,75048,36,059,519802
36059519900,5438,4848,1922,1801,121,76030,36,059,519900
36071002300,2454,1795,695,487,208,28875,36,071,002300
36071010101,5396,4326,1552,1412,140,44038,36,071,010101
36071010102,4763,3323,1634,1251,383,44659,36,071,010102
36071010200,5334,3645,2000,1692,308,49039,36,071,010200
36071010300,3457,2531,1250,1113,137,34902,36,071,010300
36071010400,3717,2297,1593,961,632,43721,36,071,010400
36071010501,3654,2368,1524,1346,178,41544,36,071,010501
36071010502,4783,2744,1802,1538,264,35757,36,071,010502
36071010601,3180,2849,1025,855,170,63286,36,071,010601
36071010602,3363,2842,1164,967,197,50902,36,071,010602
36071010701,2208,1237,800,557,243,70673,36,071,010701
36071010702,4475,3532,1797,1096,701,43333,36,071,010702
36071010801,4818,4032,1748,1051,697,37806,36,071,010801
36071010802,5863,4567,1979,1299,680,42500,36,071,010802
36071010901,3363,2653,1282,800,482,42546,36,071,010901
36071010902,5826,4819,1892,1628,264,52219,36,071,010902
36071011000,4691,3381,1880,1631,249,48789,36,071,011000
36071011101,3008,1574,950,843,107,34189,36,071,011101
36071011102,4312,2509,1611,778,833,37394,36,071,011102
36071011200,4472,2082,1893,1335,558,41700,36,071,011200
36071011301,4777,2378,1744,770,974,41723,36,071,011301
36071011302,3326,1611,1473,536,937,46969,36,071,011302
36071011400,4125,3322,1601,1470,131,41352,36,071,011400
36071011500,6673,4805,2097,1630,467,38963,36,071,011500
36071011601,3824,3186,1457,1198,259,36462,36,071,011601
36071011602,3921,2947,1544,1210,334,39150,36,071,011602
36071011701,4687,3825,1553,1260,293,52611,36,071,011701
36071011702,4503,4117,1439,1112,327,35964,36,071,011702
36071011801,4942,3649,1781,1463,318,50000,36,071,011801
36071011802,2361,2112,828,742,86,52000,36,071,011802
36071011900,6444,5288,1488,1300,188,52714,36,071,011900
36071012100,3868,2618,1478,738,740,39205,36,071,012100
36071012200,3738,3415,1527,1289,238,52100,36,071,012200
36071012300,5497,4696,1629,1629,0,51563,36,071,012300
36071012601,4468,2355,1697,1173,524,42313,36,071,012601
36071012602,2920,1298,1308,659,649,39868,36,071,012602
36071012700,3996,2971,1523,876,647,36054,36,071,012700
36071012800,4892,3560,1890,1493,397,44773,36,071,012800
36071012900,2960,2769,1172,770,402,54196,36,071,012900
36071013000,4286,3610,1673,1030,643,40046,36,071,013000
36071013100,5191,4700,1853,1528,325,53086,36,071,013100
36071013201,5087,3917,1743,1366,377,44730,36,071,013201
36071013202,2280,1564,791,676,115,50217,36,071,013202
36071013301,4531,4210,1507,1189,318,42713,36,071,013301
36071013302,2389,2128,837,734,103,72560,36,071,013302
36071013400,3302,2478,1099,869,230,50625,36,071,013400
36081083700,5398,956,1620,991,629,30796,36,081,083700
36081083800,4994,1273,1462,998,464,40657,36,081,083800
36081084000,6148,1056,1881,1378,503,45237,36,081,084000
36081084500,5010,721,1987,288,1699,30673,36,081,084500
36081084601,2941,641,826,626,200,44478,36,081,084601
36081084602,992,128,200,122,78,23750,36,081,084602
36081084901,2855,46,961,103,858,21854,36,081,084901
36081084902,4394,196,1575,84,1491,29397,36,081,084902
36081085300,5634,581,2160,813,1347,26967,36,081,085300
36081085500,6856,908,2639,246,2393,21591,36,081,085500
36081085700,5074,447,1807,355,1452,28114,36,081,085700
36081085900,5363,786,2049,815,1234,35242,36,081,085900
36081086100,2121,284,796,344,452,26225,36,081,086100
36081086300,6707,873,2394,568,1826,26998,36,081,086300
36081086400,2671,739,696,419,277,50104,36,081,086400
36081086500,4270,675,2225,420,1805,29680,36,081,086500
36081086900,1640,188,691,106,585,25674,36,081,086900
36081087100,2842,158,1164,204,960,31383,36,081,087100
36081088400,8442,6963,3225,2362,863,47926,36,081,088400
36081088902,5184,780,2222,824,1398,27420,36,081,088902
36081088903,4836,525,1799,1436,363,42741,36,081,088903
36081089201,7789,7246,2627,2304,323,67211,36,081,089201
36081089202,0,0,0,0,0,-666666666,36,081,089202
36081090700,1391,464,465,246,219,29728,36,081,090700
36081091602,0,0,0,0,0,-666666666,36,081,091602
36081091603,3527,3360,1295,1244,51,60956,36,081,091603
36081091604,0,0,0,0,0,-666666666,36,081,091604
36081091800,12,12,7,7,0,-666666666,36,081,091800
36081091900,5444,1009,1483,675,808,30019,36,081,091900
36081092200,1995,1818,779,748,31,90059,36,081,092200
36081092500,3211,859,965,376,589,26106,36,081,092500
36081092800,3731,3677,1204,1049,155,63966,36,081,092800
36081092900,6996,2021,2191,1014,1177,35354,36,081,092900
36081093401,3851,3391,1429,888,541,55274,36,081,093401
36081093402,4269,3514,1553,786,767,55926,36,081,093402
36081093800,5176,3814,2074,660,1414,44157,36,081,093800
36081093900,5885,2006,1678,881,797,39760,36,081,093900
36081094201,2988,1173,1269,275,994,50304,36,081,094201
36081094202,5479,2007,2135,976,1159,38786,36,081,094202
36081094203,6295,4289,2786,1160,1626,38623,36,081,094203
36081094500,3654,2079,1172,853,319,36230,36,081,094500
36081094700,2095,633,699,308,391,32993,36,081,094700
36081095400,6255,1115,1804,843,961,35681,36,081,095400
36081096400,6877,1428,2167,1323,844,46183,36,081,096400
36081097202,3282,232,1178,7,1171,25776,36,081,097202
36081097204,3972,625,1144,298,846,33590,36,081,097204
36103124601,2596,2497,1029,958,71,51594,36,103,124601
36103124602,4253,4032,1713,1252,461,58385,36,103,124602
36103134702,5525,5108,2320,1626,694,48468,36,103,134702
36103134703,3947,3800,1227,1191,36,51770,36,103,134703
36103134704,2770,2556,1010,772,238,53644,36,103,134704
36103134902,4887,4350,1535,1458,77,63125,36,103,134902
36103134906,5602,5273,2503,2106,397,58476,36,103,134906
36103134907,3623,3379,1321,1156,165,52271,36,103,134907
36103134908,3235,2851,1116,1004,112,71798,36,103,134908
36103134909,4467,4164,1447,1334,113,61956,36,103,134909
36103135002,5417,4998,1944,1571,373,66036,36,103,135002
36103135003,4895,4343,1654,1619,35,69679,36,103,135003
36103135004,3053,2599,1015,927,88,72045,36,103,135004
36103135005,3221,3017,1370,1308,62,66786,36,103,135005
36103135101,4028,3460,1267,1223,44,70979,36,103,135101
36103135102,4907,4525,1485,1338,147,61440,36,103,135102
36103135103,4789,4394,1524,1490,34,64474,36,103,135103
36103135104,5351,5050,1715,1606,109,56094,36,103,135104
36103135201,1804,1693,631,602,29,73816,36,103,135201
36103135205,4917,4472,1604,1389,215,57222,36,103,135205
36103135208,2972,2750,1033,1010,23,51607,36,103,135208
36103135209,3450,2848,1178,997,181,52108,36,103,135209
36103135303,4021,3569,1374,1312,62,74135,36,103,135303
36103135305,1648,1461,615,572,43,73750,36,103,135305
36103135306,4922,4629,1708,1572,136,68875,36,103,135306
36103135401,6118,5699,2067,1640,427,65116,36,103,135401
36103135402,7322,6832,2343,2108,235,54784,36,103,135402
36103135403,4403,3456,1567,1228,339,49327,36,103,135403
36103135500,5134,4697,1693,1621,72,49611,36,103,135500
36103145601,5525,2800,1360,1098,262,37150,36,103,145601
36103145602,7397,3656,1777,1501,276,37574,36,103,145602
36103145603,6660,3422,1617,1122,495,37576,36,103,145603
36103145604,5188,2687,984,761,223,30567,36,103,145604
36103145605,3784,1906,882,626,256,31318,36,103,145605
36103145701,4809,3321,1620,891,729,42839,36,103,145701
36103145702,6998,3752,1571,1296,275,37720,36,103,145702
36103145703,4174,2418,1085,588,497,32628,36,103,145703
36103145705,3158,1589,1200,654,546,31156,36,103,145705
36103145706,4997,1813,1082,923,159,39438,36,103,145706
36103145803,4949,4491,1633,1513,120,53611,36,103,145803
36103145804,3315,1782,1086,1012,74,39643,36,103,145804
36103145807,4285,3842,1264,1201,63,45881,36,103,145807
36103145808,3538,2267,1173,1071,102,52842,36,103,145808
36103145809,2036,1721,653,543,110,62875,36,103,145809
36103145810,3227,2802,1227,1069,158,46075,36,103,145810
36121971100,2592,2348,993,838,155,27117,36,121,971100
36123150101,3898,3736,1380,1052,328,26226,36,123,150101
36123150102,2346,2283,789,686,103,30913,36,123,150102
36123150200,5341,5162,1849,1177,672,31446,36,123,150200
36123150301,2801,2706,985,881,104,32277,36,123,150301
36123150302,1935,1890,774,704,70,37756,36,123,150302
36123150400,3944,3752,1292,920,372,17161,36,123,150400
36123150501,2046,1808,974,607,367,34397,36,123,150501
36123150502,2670,2651,858,778,80,27895,36,123,150502
36001000100,2029,481,769,280,489,25807,36,001,000100
36001000201,3263,643,1382,265,1117,29386,36,001,000201
36001000202,2153,86,913,257,656,17743,36,001,000202
36001000301,3016,847,1135,311,824,27731,36,001,000301
36001000302,2931,1936,1585,586,999,32386,36,001,000302
36001000401,2336,2017,938,629,309,48851,36,001,000401
36001000403,4014,2869,2119,1038,1081,50257,36,001,000403
36001000404,5045,3107,0,0,0,3578,36,001,000404
36001000501,3410,1603,1494,366,1128,21607,36,001,000501
36001000502,3926,2253,956,321,635,7184,36,001,000502
36001000600,3773,1493,1483,161,1322,12911,36,001,000600
36001000700,3611,503,1391,362,1029,29036,36,001,000700
36001000800,2102,232,845,114,731,26974,36,001,000800
36001001100,1751,935,979,75,904,42417,36,001,001100
36001001400,4288,3217,2871,401,2470,40824,36,001,001400
36001001500,4621,2777,2268,344,1924,16342,36,001,001500
36001001600,4156,2804,1789,519,1270,33893,36,001,001600
36001001700,4041,2946,1857,918,939,40978,36,001,001700
36001001802,3937,3219,1945,1100,845,36102,36,001,001802
36001001803,3544,3085,1861,1465,396,54640,36,001,001803
36001001804,3537,2545,1754,1396,358,47296,36,001,001804
36001001901,2496,2015,1246,880,366,48438,36,001,001901
36001001902,2278,1728,978,932,46,51944,36,001,001902
36001002000,6067,2939,2313,1164,1149,28422,36,001,002000
36001002100,3174,1517,1074,149,925,21003,36,001,002100
36001002200,2657,1723,1453,306,1147,26141,36,001,002200
36001002300,1712,720,1122,125,997,42663,36,001,002300
36001002500,3063,497,1456,114,1342,25313,36,001,002500
36001002600,3929,1376,1638,711,927,31074,36,001,002600
36001012700,3207,2583,1499,447,1052,35853,36,001,012700
36001012800,3527,2412,1561,375,1186,26140,36,001,012800
36001012900,3330,2801,1742,190,1552,33988,36,001,012900
36001013000,6644,6301,2744,2056,688,43813,36,001,013000
36001013100,2647,2112,1303,360,943,34786,36,001,013100
36001013200,3393,2480,1715,368,1347,27066,36,001,013200
36001013300,3775,2854,2253,564,1689,41686,36,001,013300
36001013400,2808,2340,1102,519,583,35180,36,001,013400
36059520001,7846,6512,2658,2329,329,56317,36,059,520001
36059520002,4728,3748,1580,1372,208,46467,36,059,520002
36059520100,5450,4391,1943,1832,111,72367,36,059,520100
36059520200,3254,2361,941,869,72,47399,36,059,520200
36059520300,5611,4873,1969,1828,141,55417,36,059,520300
36059520401,4436,3648,1870,1301,569,59295,36,059,520401
36059520402,4433,3375,1850,1129,721,61160,36,059,520402
36059520501,3866,3316,1175,1095,80,47153,36,059,520501
36059520502,5179,4564,1703,1620,83,54819,36,059,520502
36059520600,5721,4777,1869,1745,124,57779,36,059,520600
36059520700,4786,4349,1709,1532,177,65333,36,059,520700
36059520800,4166,3966,1360,1335,25,57625,36,059,520800
36059520900,4750,4573,1622,1614,8,51154,36,059,520900
36059521000,4537,4269,1544,1438,106,56019,36,059,521000
36059521100,4529,4341,1548,1478,70,62104,36,059,521100
36059521200,2911,2540,957,874,83,61078,36,059,521200
36059521301,2695,2332,858,840,18,60216,36,059,521301
36059521302,5121,4905,1770,1688,82,54639,36,059,521302
36059521400,6275,6254,2018,1962,56,65883,36,059,521400
36059521500,5119,4548,1713,1666,47,61250,36,059,521500
36059521601,4334,4248,1410,1362,48,70531,36,059,521601
36059521602,3204,3059,1064,1050,14,61172,36,059,521602
36059521700,4495,4113,1712,1701,11,77625,36,059,521700
36059521801,3914,3584,1356,1306,50,62398,36,059,521801
36059521802,3718,3538,1197,1156,41,44893,36,059,521802
36059521902,4186,4125,1452,1383,69,74265,36,059,521902
36059522000,6746,3240,3007,2171,836,45607,36,059,522000
36059522700,4735,4242,1584,1500,84,65599,36,059,522700
36059980100,1007,713,0,0,0,3523,36,059,980100
36059981100,1001,646,5,5,0,3556,36,059,981100
36059982100,1292,655,7,0,7,3795,36,059,982100
36059990100,0,0,0,0,0,-666666666,36,059,990100
36059990200,0,0,0,0,0,-666666666,36,059,990200
36059990301,0,0,0,0,0,-666666666,36,059,990301
36059990302,0,0,0,0,0,-666666666,36,059,990302
36059990400,0,0,0,0,0,-666666666,36,059,990400
36061000100,0,0,0,0,0,-666666666,36,061,000100
36061000201,2761,365,864,0,864,29200,36,061,000201
36061000202,6908,2871,3216,818,2398,39766,36,061,000202
36061000500,0,0,0,0,0,-666666666,36,061,000500
36061000600,10628,967,4470,187,4283,22260,36,061,000600
36061000700,8500,6498,4571,753,3818,102441,36,061,000700
36061000800,9292,1077,4094,105,3989,26756,36,061,000800
36061000900,1886,1263,883,122,761,117188,36,061,000900
36061001001,1437,1050,785,515,270,80109,36,061,001001
36061001002,5077,1438,2312,0,2312,24697,36,061,001002
36071013500,6058,4702,1927,1733,194,45556,36,071,013500
36071013600,6328,4794,952,5,947,14343,36,071,013600
36071013700,2736,1512,1134,571,563,41503,36,071,013700
36071013800,3188,2103,1269,761,508,44740,36,071,013800
36071013900,4642,3656,1393,1290,103,46406,36,071,013900
36071014101,4486,2755,1388,1035,353,41085,36,071,014101
36071014102,5856,2694,1914,1015,899,41623,36,071,014102
36071014201,3431,2615,1157,1057,100,45231,36,071,014201
36071014202,6220,4777,1972,1849,123,55329,36,071,014202
36071014301,4942,3299,2005,1163,842,41101,36,071,014301
36071014302,7152,5557,2223,2081,142,51987,36,071,014302
36071014400,4646,3828,1605,1304,301,52167,36,071,014400
36071014501,4145,3657,1438,1261,177,51918,36,071,014501
36071014502,5720,5405,2183,1575,608,68427,36,071,014502
36071014601,2960,2809,1492,1042,450,51823,36,071,014601
36071014602,3933,3607,1298,906,392,37457,36,071,014602
36071014700,4229,3589,1436,1269,167,40804,36,071,014700
36071014801,2452,2392,940,746,194,43906,36,071,014801
36071014802,3117,2652,1090,841,249,33090,36,071,014802
36071014900,3531,3083,1414,1138,276,68889,36,071,014900
36071015003,7938,7683,1352,338,1014,29473,36,071,015003
36071015005,4621,4592,886,176,710,25058,36,071,015005
36071015007,4179,4179,770,346,424,25183,36,071,015007
36071015008,3316,3303,665,146,519,22756,36,071,015008
36071015009,2321,2158,322,161,161,18500,36,071,015009
36071015010,4230,4230,731,262,469,29188,36,071,015010
36071015100,6137,2729,2123,918,1205,29809,36,071,015100
36071015201,4267,3517,1371,1238,133,61710,36,071,015201
36071015202,5436,3491,1690,1438,252,61320,36,071,015202
36071015203,1537,812,469,211,258,41438,36,071,015203
36073040200,3142,2805,1432,1272,160,41875,36,073,040200
36073040300,2394,2169,935,784,151,37009,36,073,040300
36073040400,3201,2845,1365,881,484,30987,36,073,040400
36073040500,2666,2242,1203,680,523,21283,36,073,040500
36073040601,1769,1687,658,560,98,29148,36,073,040601
36073040602,2244,1119,0,0,0,9375,36,073,040602
36073040603,3299,3159,1536,1026,510,28333,36,073,040603
36073040701,2768,2416,1233,710,523,25974,36,073,040701
36073040702,3134,2687,1606,1036,570,30866,36,073,040702
36073040801,3491,3368,1530,1334,196,31720,36,073,040801
36073040802,4686,4150,1914,1474,440,31806,36,073,040802
36073401200,3378,3085,1330,1062,268,32030,36,073,401200
36073401300,4452,4181,1892,1672,220,36554,36,073,401300
36073990000,0,0,0,0,0,-666666666,36,073,990000
36075020101,2275,2215,831,783,48,27857,36,075,020101
36075020102,1452,1412,491,413,78,32600,36,075,020102
36081097205,3523,689,1176,0,1176,22063,36,081,097205
36081097206,3334,191,1271,141,1130,25625,36,081,097206
36081097207,0,0,0,0,0,-666666666,36,081,097207
36081097300,1947,1696,705,594,111,53365,36,081,097300
36081098100,2217,1632,750,615,135,44400,36,081,098100
36081098700,2498,2086,903,657,246,45236,36,081,098700
36081099100,7252,5375,2807,2430,377,54508,36,081,099100
36081099200,4349,1052,1444,326,1118,32207,36,081,099200
36081099701,2734,2062,1150,968,182,69073,36,081,099701
36081099703,3481,1980,1659,1138,521,63854,36,081,099703
36081099704,6915,4901,3572,2515,1057,50458,36,081,099704
36081099705,2791,1099,939,665,274,42981,36,081,099705
36081099801,8631,782,2634,401,2233,36657,36,081,099801
36081099802,6104,1345,2450,63,2387,36761,36,081,099802
36081099900,0,0,0,0,0,-666666666,36,081,099900
36081100801,2708,1062,669,533,136,47500,36,081,100801
36081100803,3640,1119,1201,479,722,30174,36,081,100803
36081100804,4843,2055,1433,776,657,37914,36,081,100804
36081101002,4860,3229,1634,622,1012,32158,36,081,101002
36081101003,4393,2191,1138,141,997,30672,36,081,101003
36081101004,7611,2955,2407,638,1769,30743,36,081,101004
36081101700,6191,3689,2248,1953,295,52679,36,081,101700
36081102900,3636,2636,1413,743,670,50737,36,081,102900
36081103201,5981,1542,1753,299,1454,26598,36,081,103201
36081103202,8592,5479,2256,655,1601,32374,36,081,103202
36081103300,4736,2450,1363,884,479,38536,36,081,103300
36081103900,6067,3042,2189,1163,1026,31939,36,081,103900
36081104700,6738,2187,2599,1440,1159,38089,36,081,104700
36081105900,3845,2490,1204,1084,120,60549,36,081,105900
36081107201,2257,1980,813,637,176,70703,36,081,107201
36081107202,0,0,0,0,0,-666666666,36,081,107202
36081108500,2467,1524,962,668,294,39276,36,081,108500
36081109300,2789,1391,1001,859,142,60800,36,081,109300
36081109700,1676,965,630,502,128,53304,36,081,109700
36081109900,3153,1579,1169,858,311,40142,36,081,109900
36081111300,2634,1443,780,605,175,56793,36,081,111300
36081112300,2085,968,721,214,507,52971,36,081,112300
36081112900,2120,1033,738,523,215,48583,36,081,112900
36081113300,1498,929,628,506,122,51579,36,081,113300
36081113900,3589,1404,1449,623,826,52891,36,081,113900
36081114100,2373,1423,848,750,98,53547,36,081,114100
36081114700,1836,954,622,524,98,48259,36,081,114700
36081115100,849,473,332,301,31,43641,36,081,115100
36081115500,2366,637,730,297,433,33882,36,081,115500
36081115700,3007,555,1156,414,742,27083,36,081,115700
36081115900,4063,441,1556,548,1008,26414,36,081,115900
36103145901,3124,1866,916,760,156,37056,36,103,145901
36103145903,6538,4875,1769,1449,320,53983,36,103,145903
36103145904,5187,1760,938,645,293,25351,36,103,145904
36103145905,4450,2124,1168,667,501,32258,36,103,145905
36103146001,5380,2259,1111,844,267,29625,36,103,146001
36103146002,5398,2463,1185,1018,167,34337,36,103,146002
36103146004,1850,835,450,292,158,40708,36,103,146004
36103146005,9281,2759,1896,1384,512,38389,36,103,146005
36103146102,2910,1626,667,578,89,31598,36,103,146102
36103146103,4254,3439,1174,1101,73,42824,36,103,146103
36103146105,6249,3194,1667,1167,500,34845,36,103,146105
36103146106,5000,1946,1126,623,503,40876,36,103,146106
36103146201,5246,3146,1230,958,272,34696,36,103,146201
36103146202,4902,1585,1221,1087,134,30367,36,103,146202
36103146203,5044,2266,1303,823,480,33743,36,103,146203
36103146204,6497,3564,1687,1552,135,42922,36,103,146204
36103146205,2066,1886,617,574,43,39063,36,103,146205
36103146206,1867,1304,653,610,43,56570,36,103,146206
36103146300,2289,1448,1227,888,339,58750,36,103,146300
36103146402,3708,3047,1279,985,294,62194,36,103,146402
36103146403,5543,2652,1368,954,414,26750,36,103,146403
36103146404,3172,1794,864,770,94,30045,36,103,146404
36103146500,5244,4767,1717,1521,196,50355,36,103,146500
36103146607,2516,1949,1041,552,489,42230,36,103,146607
36103146608,2803,2507,1057,565,492,58625,36,103,146608
36103146611,2855,2378,988,603,385,41840,36,103,146611
36103146612,4913,4388,1465,1408,57,52847,36,103,146612
36103146613,3810,3282,1147,919,228,48680,36,103,146613
36103146614,4654,4452,1719,1632,87,54833,36,103,146614
36103146616,4058,3895,1307,1242,65,47750,36,103,146616
36103146617,2755,2556,1007,856,151,42469,36,103,146617
36103146618,5867,4711,1842,1170,672,49236,36,103,146618
36103146619,2553,2062,1073,527,546,49963,36,103,146619
36103146620,1806,1567,716,376,340,55446,36,103,146620
36103146703,3791,2818,1058,941,117,42931,36,103,146703
36103146704,2286,2112,749,747,2,49967,36,103,146704
36103146705,2967,2653,935,928,7,62928,36,103,146705
36103146706,2468,2386,814,758,56,47310,36,103,146706
36103146800,6243,6004,1802,1675,127,46806,36,103,146800
36103146901,5176,4576,1767,1757,10,65724,36,103,146901
36103146902,3578,3227,1088,1038,50,54444,36,103,146902
36103147001,4527,4414,1454,1386,68,63820,36,103,147001
36103147003,4506,3900,1650,1573,77,50809,36,103,147003
36103147004,164,146,73,59,14,38696,36,103,147004
36103147100,3070,2785,1022,961,61,64211,36,103,147100
36001013503,5030,3580,1960,1171,789,48507,36,001,013503
36001013505,2753,2461,1063,874,189,41594,36,001,013505
36001013507,2273,1616,990,508,482,52384,36,001,013507
36001013509,3599,2986,1376,919,457,37941,36,001,013509
36001013510,3671,2569,1518,672,846,37254,36,001,013510
36001013511,3411,1869,1274,770,504,62468,36,001,013511
36001013512,3422,3022,1359,1166,193,42726,36,001,013512
36001013602,3889,1889,1671,567,1104,56300,36,001,013602
36001013603,3347,2472,1529,888,641,51825,36,001,013603
36001013604,6472,5083,2062,1100,962,9338,36,001,013604
36001013703,2407,1703,622,568,54,36875,36,001,013703
36001013706,2041,1995,738,661,77,51767,36,001,013706
36001013707,5878,4939,2332,1846,486,51103,36,001,013707
36001013708,3146,2815,1619,1109,510,52882,36,001,013708
36001013709,3140,2499,1243,995,248,48591,36,001,013709
36001013802,4261,3942,1597,1482,115,53185,36,001,013802
36001013803,3169,2459,1294,1011,283,36103,36,001,013803
36001013804,4035,3133,1765,1510,255,45875,36,001,013804
36001013901,2270,1942,920,857,63,37225,36,001,013901
36001013902,5416,4567,1940,1493,447,41644,36,001,013902
36001014001,3767,2779,1811,893,918,42838,36,001,014001
36001014002,5251,4461,2095,1510,585,40481,36,001,014002
36001014100,5508,4987,2447,1658,789,47326,36,001,014100
36001014201,5781,4999,2277,1516,761,49533,36,001,014201
36001014202,6085,5805,2606,1755,851,54268,36,001,014202
36001014203,6181,5625,2629,2134,495,65657,36,001,014203
36001014301,3207,2758,1281,928,353,40490,36,001,014301
36001014303,5083,4642,1865,1633,232,70401,36,001,014303
36001014304,3166,2939,1427,831,596,49750,36,001,014304
36001014401,4124,4033,1748,1405,343,40313,36,001,014401
36001014402,3181,2794,1385,877,508,28500,36,001,014402
36001014501,2458,2230,987,913,74,47618,36,001,014501
36001014502,3424,3305,1282,1176,106,45556,36,001,014502
36001014503,2789,2694,1115,873,242,50052,36,001,014503
36001014606,3659,3325,1435,1281,154,49278,36,001,014606
36001014608,4191,3099,1220,900,320,15769,36,001,014608
36001014609,4598,3626,2408,1047,1361,47460,36,001,014609
36001014611,2278,1843,888,659,229,53211,36,001,014611
36001014612,1754,1566,689,507,182,46852,36,001,014612
36001014613,2860,2664,1130,924,206,38148,36,001,014613
36001014614,5329,4104,2351,1278,1073,59955,36,001,014614
36001014615,2909,1782,1259,303,956,54876,36,001,014615
36001014616,5773,4959,2184,1739,445,61100,36,001,014616
36001014617,2383,2100,919,896,23,63571,36,001,014617
36001014700,2738,2727,1038,986,52,46684,36,001,014700
36001014801,2783,2674,1205,1069,136,36027,36,001,014801
36061001200,4258,2606,1915,796,1119,53083,36,061,001200
36061001300,4690,3056,2695,427,2268,101770,36,061,001300
36061001401,2999,2283,1569,1293,276,78488,36,061,001401
36061001402,2693,949,1476,77,1399,63300,36,061,001402
36061001501,8021,4995,3720,1738,1982,82360,36,061,001501
36061001502,7929,5730,3571,489,3082,91836,36,061,001502
36061001600,7504,1581,3147,352,2795,47865,36,061,001600
36061001800,7101,2204,3095,181,2914,43227,36,061,001800
36061002000,4606,808,1964,8,1956,25874,36,061,002000
36061002100,6868,5398,2897,1216,1681,141750,36,061,002100
36061002201,6372,2263,2988,327,2661,30133,36,061,002201
36061002202,2123,1432,1035,60,975,80270,36,061,002202
36061002400,4171,471,1807,14,1793,24535,36,061,002400
36061002500,5483,557,2026,0,2026,25853,36,061,002500
36061002601,3977,1597,1797,143,1654,44735,36,061,002601
36061002602,3633,2511,1873,333,1540,59784,36,061,002602
36061002700,1417,263,614,378,236,81000,36,061,002700
36061002800,6404,3203,3176,390,2786,62798,36,061,002800
36061002901,1564,659,46,0,46,8533,36,061,002901
36061002902,4151,394,2210,230,1980,32090,36,061,002902
36061003001,3727,2487,2082,72,2010,63403,36,061,003001
36061003002,2929,1841,1617,123,1494,81227,36,061,003002
36061003100,2616,1540,740,208,532,39457,36,061,003100
36061003200,7873,6461,4606,853,3753,73305,36,061,003200
36061003300,5841,4831,2608,970,1638,139653,36,061,003300
36061003400,6648,4771,3700,253,3447,76952,36,061,003400
36061003601,2909,1269,1480,164,1316,49050,36,061,003601
36061003602,3300,2368,1324,189,1135,54060,36,061,003602
36061003700,2746,2103,1389,669,720,102870,36,061,003700
36061003800,8886,5576,4817,411,4406,62457,36,061,003800
36061003900,7132,5900,3107,1022,2085,106310,36,061,003900
36061004001,3599,2660,2121,354,1767,80875,36,061,004001
36061004002,5615,4275,1987,318,1669,73053,36,061,004002
36061004100,7526,3549,3311,224,3087,60938,36,061,004100
36061004200,5311,3314,1577,485,1092,23728,36,061,004200
36061004300,3684,2537,2289,330,1959,74838,36,061,004300
36061004400,16600,11625,8078,0,8078,80495,36,061,004400
36061004500,1040,768,464,211,253,100057,36,061,004500
36061004700,2423,1813,1450,429,1021,97951,36,061,004700
36061004800,6351,4854,2812,1517,1295,81852,36,061,004800
36061004900,4512,3845,2625,640,1985,70411,36,061,004900
36061005000,5072,4072,2820,1441,1379,125647,36,061,005000
36061005200,3202,2305,1335,811,524,103365,36,061,005200
36061005400,4628,3360,2734,1234,1500,119191,36,061,005400
36061005501,4734,3183,1982,525,1457,103948,36,061,005501
36061005502,1796,1436,1003,271,732,98533,36,061,005502
36075020201,2475,2453,1060,855,205,27417,36,075,020201
36075020202,1293,1261,556,406,150,35893,36,075,020202
36075020301,2217,2186,943,521,422,34815,36,075,020301
36075020303,1769,1745,642,609,33,36588,36,075,020303
36075020304,1583,1317,621,474,147,30718,36,075,020304
36075020400,5073,4907,2106,1544,562,31828,36,075,020400
36075020501,1813,1709,654,530,124,28688,36,075,020501
36075020502,2624,2524,1105,929,176,37188,36,075,020502
36075020503,1188,1160,453,375,78,31345,36,075,020503
36075020600,4836,4598,2045,1726,319,39464,36,075,020600
36075020703,5008,4908,2027,1905,122,36628,36,075,020703
36075020704,2141,2091,910,764,146,44504,36,075,020704
36075020705,1966,1915,812,608,204,34492,36,075,020705
36075020706,2339,2251,992,525,467,34970,36,075,020706
36075020707,1889,1847,788,592,196,38906,36,075,020707
36075020800,3532,3247,1292,1099,193,40010,36,075,020800
36075020901,2643,2567,1146,449,697,29487,36,075,020901
36075020903,2621,2473,1157,1090,67,44479,36,075,020903
36075020904,1700,1666,662,576,86,31781,36,075,020904
36075020905,1170,1148,420,362,58,38816,36,075,020905
36075021001,2284,2203,824,737,87,27500,36,075,021001
36075021002,2400,2340,915,594,321,40884,36,075,021002
36075021003,1002,952,409,373,36,46875,36,075,021003
36075021101,3353,3170,1400,692,708,31726,36,075,021101
36075021102,2321,2097,921,360,561,21309,36,075,021102
36075021103,3000,2944,1239,938,301,34806,36,075,021103
36075021104,2535,2402,1097,576,521,35295,36,075,021104
36075021201,1043,1043,389,282,107,24440,36,075,021201
36075021202,2984,2958,1088,681,407,45483,36,075,021202
36075021203,2462,2403,1048,934,114,29527,36,075,021203
36075021300,4593,4407,1793,1430,363,29866,36,075,021300
36075021401,7532,6236,1548,1432,116,7091,36,075,021401
36075021402,1781,1681,739,609,130,40528,36,075,021402
36075021501,2842,2774,1099,918,181,30908,36,075,021501
36075021503,2134,2124,973,863,110,43505,36,075,021503
36075021504,2421,2305,1123,967,156,30017,36,075,021504
36075021505,1965,1942,815,512,303,31014,36,075,021505
36075021601,2584,2297,1268,547,721,22415,36,075,021601
36075021602,3114,2852,1170,424,746,12865,36,075,021602
36075021603,3446,3224,1538,1052,486,45977,36,075,021603
36075021604,4732,4460,2046,957,1089,32972,36,075,021604
36075021605,3495,3188,1442,899,543,28095,36,075,021605
36075990000,0,0,0,0,0,-666666666,36,075,990000
36077590101,2431,2413,925,748,177,32188,36,077,590101
36077590102,1820,1699,787,673,114,35278,36,077,590102
36077590201,2257,2174,929,733,196,32305,36,077,590201
36081116100,4197,485,1501,488,1013,26978,36,081,116100
36081116301,4630,652,1537,310,1227,20670,36,081,116301
36081116302,4200,806,1353,297,1056,25849,36,081,116302
36081116700,1894,198,585,124,461,25377,36,081,116700
36081117100,2309,734,833,346,487,26744,36,081,117100
36081117500,4709,1609,1760,782,978,40875,36,081,117500
36081118100,1632,786,626,249,377,32159,36,081,118100
36081118500,1916,271,608,66,542,32648,36,081,118500
36081118700,2354,713,777,355,422,25893,36,081,118700
36081118900,1957,431,765,342,423,31827,36,081,118900
36081119100,2827,469,923,352,571,31662,36,081,119100
36081119300,2107,470,758,377,381,33384,36,081,119300
36081119500,1305,532,383,264,119,43052,36,081,119500
36081119900,1482,381,457,345,112,38558,36,081,119900
36081120100,1506,293,376,195,181,36842,36,081,120100
36081120300,1433,263,444,237,207,29861,36,081,120300
36081120500,2587,212,989,309,680,29104,36,081,120500
36081120701,3109,1138,958,793,165,38690,36,081,120701
36081120702,0,0,0,0,0,-666666666,36,081,120702
36081121100,0,0,0,0,0,-666666666,36,081,121100
36081121500,4456,1081,1215,786,429,38896,36,081,121500
36081122300,3512,1335,1295,916,379,-666666666,36,081,122300
36081122702,6509,2425,2871,356,2515,24554,36,081,122702
36081122703,6523,2929,2649,1108,1541,49412,36,081,122703
36081122704,4929,1093,2127,646,1481,39693,36,081,122704
36081124100,4094,1145,1384,894,490,45860,36,081,124100
36081124700,3498,1368,1104,971,133,36997,36,081,124700
36081125700,3290,544,974,461,513,30180,36,081,125700
36081126500,1701,481,528,388,140,53640,36,081,126500
36081126700,4738,2034,717,502,215,8050,36,081,126700
36081127700,3162,2457,1043,969,74,64901,36,081,127700
36081128300,0,0,0,0,0,-666666666,36,081,128300
36081129102,3957,2660,1227,1096,131,58906,36,081,129102
36081129103,4094,2462,1922,1522,400,51181,36,081,129103
36081129104,4112,2448,1726,1286,440,53209,36,081,129104
36081130100,3963,1118,1466,1289,177,52775,36,081,130100
36081133300,3876,2093,1234,1010,224,42388,36,081,133300
36081133900,1289,662,405,387,18,77348,36,081,133900
36081134100,3570,1349,1085,745,340,37543,36,081,134100
36081134701,5302,1089,1850,124,1726,38456,36,081,134701
36081134702,4904,1238,1836,484,1352,48786,36,081,134702
36081136700,6068,1913,2232,1558,674,47622,36,081,136700
36081137700,7325,2124,2562,1401,1161,39834,36,081,137700
36081138501,4305,1558,1397,704,693,47370,36,081,138501
36081138502,90,81,0,0,0,-666666666,36,081,138502
36081139900,1587,552,557,490,67,62188,36,081,139900
36103147201,3540,2115,1534,820,714,55427,36,103,147201
36103147202,2314,1409,748,352,396,42875,36,103,147202
36103147301,3314,994,1181,1006,175,44802,36,103,147301
36103147302,4351,3269,1958,893,1065,48772,36,103,147302
36103147401,5781,4748,2349,1975,374,53950,36,103,147401
36103147402,2997,2825,1267,1206,61,63333,36,103,147402
36103147502,5247,5182,1884,1812,72,68646,36,103,147502
36103147503,1920,1806,707,527,180,53869,36,103,147503
36103147504,1058,919,405,380,25,59934,36,103,147504
36103147505,6417,4999,2239,1651,588,46250,36,103,147505
36103147601,2433,2055,799,773,26,43704,36,103,147601
36103147602,4558,4244,1924,1489,435,52979,36,103,147602
36103147701,3432,3196,1127,863,264,49449,36,103,147701
36103147702,4953,4695,1698,1393,305,56504,36,103,147702
36103147802,3540,3260,1275,1038,237,76600,36,103,147802
36103147803,3016,2859,1371,697,674,72105,36,103,147803
36103147804,5922,5663,1781,1602,179,64643,36,103,147804
36103147901,4159,3626,1684,995,689,50229,36,103,147901
36103147902,4425,4220,1523,1472,51,68869,36,103,147902
36103158001,3596,3239,1301,1128,173,76652,36,103,158001
36103158009,2168,1949,759,727,32,61458,36,103,158009
36103158010,2888,2531,946,920,26,78017,36,103,158010
36103158011,4321,3616,1663,1516,147,62025,36,103,158011
36103158012,4065,2633,1431,1376,55,80255,36,103,158012
36103158013,2268,1987,906,879,27,51838,36,103,158013
36103158014,743,374,0,0,0,17647,36,103,158014
36103158015,7831,2477,0,0,0,2910,36,103,158015
36103158016,2195,1841,737,566,171,118788,36,103,158016
36103158017,3590,3357,1418,1164,254,63806,36,103,158017
36103158102,4414,3727,1520,1189,331,48949,36,103,158102
36103158103,4864,3789,1382,1090,292,42367,36,103,158103
36103158107,3655,2981,1262,1070,192,47446,36,103,158107
36103158108,2656,1887,807,600,207,50435,36,103,158108
36103158111,3463,2510,1012,947,65,39865,36,103,158111
36103158112,4166,3195,1205,984,221,46179,36,103,158112
36103158114,3369,3133,1080,816,264,52344,36,103,158114
36103158116,2083,1754,713,647,66,50664,36,103,158116
36103158117,2999,2612,1036,1013,23,52903,36,103,158117
36103158118,3524,2843,1401,947,454,34712,36,103,158118
36103158119,6265,5021,1874,1652,222,46324,36,103,158119
36103158120,2545,2367,809,761,48,46712,36,103,158120
36103158205,1557,1529,527,502,25,60729,36,103,158205
36103158206,3964,3521,1517,1023,494,53214,36,103,158206
36103158207,4843,4147,1894,1532,362,67675,36,103,158207
36103158208,4422,3944,1480,1208,272,47667,36,103,158208
36001014802,1771,1755,779,714,65,42385,36,001,014802
36001014803,3313,3266,1257,1089,168,48154,36,001,014803
36061005600,4043,2643,2329,752,1577,121543,36,061,005600
36061005700,2887,2456,1415,595,820,102023,36,061,005700
36061005800,4226,2754,2336,163,2173,111726,36,061,005800
36061005900,5571,4556,2715,1664,1051,86469,36,061,005900
36061006000,5849,4800,2465,0,2465,119750,36,061,006000
36061006100,4647,3252,1940,1038,902,75829,36,061,006100
36061006200,4355,2103,1340,0,1340,45303,36,061,006200
36061006300,6318,5501,3353,1529,1824,102117,36,061,006300
36061006400,7425,5582,4208,1372,2836,87399,36,061,006400
36061006500,6112,4994,3344,277,3067,67048,36,061,006500
36061006600,11916,7937,6549,2306,4243,81210,36,061,006600
36061006700,5165,4587,3304,574,2730,90736,36,061,006700
36061006800,7744,5262,3660,1216,2444,107897,36,061,006800
36061006900,2341,2017,1045,503,542,104000,36,061,006900
36061007001,4035,3260,2102,595,1507,76985,36,061,007001
36061007002,3779,2688,2172,323,1849,100565,36,061,007002
36061007100,5337,4214,2782,1174,1608,122439,36,061,007100
36061007200,7534,5579,4210,824,3386,101724,36,061,007200
36061007300,5807,5061,3607,711,2896,109751,36,061,007300
36061007400,4448,3380,2405,693,1712,102681,36,061,007400
36061007500,3467,2938,2220,863,1357,90653,36,061,007500
36061007600,2115,1130,1215,277,938,90081,36,061,007600
36061007700,5640,4912,3310,1081,2229,103163,36,061,007700
36061007800,9810,5910,4847,1140,3707,80907,36,061,007800
36061007900,4370,3878,2406,725,1681,107540,36,061,007900
36061008000,4722,3681,2802,1354,1448,90363,36,061,008000
36061008100,7302,6388,4356,1708,2648,102345,36,061,008100
36061008200,3140,1849,1902,970,932,124188,36,061,008200
36061008300,3742,1824,2136,455,1681,52272,36,061,008300
36061008400,1524,898,819,310,509,104722,36,061,008400
36061008601,2899,1912,1264,299,965,100587,36,061,008601
36061008602,0,0,0,0,0,-666666666,36,061,008602
36061008603,4554,3719,2450,1603,847,103182,36,061,008603
36061008700,6347,4804,3951,1391,2560,100422,36,061,008700
36061008800,7548,4932,4507,1772,2735,85981,36,061,008800
36061008900,5599,4629,2985,940,2045,84612,36,061,008900
36061009000,7767,5919,4682,1444,3238,82200,36,061,009000
36061009100,6046,4290,3524,1107,2417,118537,36,061,009100
36061009200,1539,936,938,151,787,110250,36,061,009200
36061009300,9934,7214,5366,2250,3116,66475,36,061,009300
36061009400,64,60,49,4,45,136875,36,061,009400
36061009500,2985,2537,1148,417,731,85577,36,061,009500
36061009600,185,126,141,18,123,109250,36,061,009600
36061009700,4490,2618,2871,1560,1311,52455,36,061,009700
36061009800,7099,5657,4347,1612,2735,102388,36,061,009800
36061009901,1928,1708,1014,215,799,195083,36,061,009901
36077590202,3717,3299,1662,1111,551,37311,36,077,590202
36077590301,2079,2063,857,616,241,31364,36,077,590301
36077590302,1887,1856,713,612,101,36902,36,077,590302
36077590401,1846,1701,676,574,102,32451,36,077,590401
36077590402,3486,3317,1418,1252,166,31130,36,077,590402
36077590500,2889,2750,1239,889,350,29654,36,077,590500
36077590600,1787,1730,702,609,93,31926,36,077,590600
36077590701,1751,1714,797,654,143,34301,36,077,590701
36077590702,1987,1889,777,637,140,30550,36,077,590702
36077590800,4966,4336,2125,1582,543,39550,36,077,590800
36077590900,2769,2584,1294,715,579,39704,36,077,590900
36077591000,3454,3074,1357,687,670,20683,36,077,591000
36077591100,2775,2315,1461,389,1072,21101,36,077,591100
36077591401,2889,2797,1218,818,400,26008,36,077,591401
36077591402,2268,2215,1005,726,279,33320,36,077,591402
36077591500,3550,3427,1454,1249,205,32072,36,077,591500
36077591601,1781,1679,795,665,130,30492,36,077,591601
36077591602,2347,2284,1104,834,270,36491,36,077,591602
36077591700,4857,4007,473,384,89,4420,36,077,591700
36079010100,3640,2837,1340,1124,216,50050,36,079,010100
36079010201,4576,4008,1649,1518,131,51713,36,079,010201
36079010202,3640,2759,913,631,282,32030,36,079,010202
36079010300,4903,3186,1664,1518,146,41301,36,079,010300
36079010400,3260,2959,1242,1082,160,47227,36,079,010400
36079010500,5062,4219,1846,1522,324,56586,36,079,010500
36079010600,3615,3322,1341,1188,153,50536,36,079,010600
36079010700,2583,2371,1115,763,352,71037,36,079,010700
36079010800,3522,3060,1150,1044,106,38393,36,079,010800
36079010901,3624,2817,1160,973,187,36679,36,079,010901
36079010902,4028,3464,1397,1285,112,50239,36,079,010902
36079011000,3907,3516,1387,1299,88,55610,36,079,011000
36079011100,5245,4593,1773,1693,80,44349,36,079,011100
36079011201,2806,2710,970,914,56,40194,36,079,011201
36079011202,4629,4100,1495,1067,428,44103,36,079,011202
36079011300,4258,4112,1485,1261,224,59844,36,079,011300
36079011400,5134,4885,1855,1457,398,48189,36,079,011400
36079011501,3592,3344,1606,956,650,32051,36,079,011501
36079011502,2591,2299,1021,860,161,66343,36,079,011502
36079011600,5981,5164,1990,1618,372,40662,36,079,011600
36079011700,4945,4390,1731,1514,217,54144,36,079,011700
36079011801,3405,1923,1232,472,760,32745,36,079,011801
36079011802,4792,3746,1769,1547,222,40700,36,079,011802
36079011900,4976,4164,1784,1491,293,52606,36,079,011900
36081000101,4809,2463,2204,532,1672,99976,36,081,000101
36081000102,5117,3100,2320,51,2269,102234,36,081,000102
36081000103,0,0,0,0,0,-666666666,36,081,000103
36081140901,1086,321,352,231,121,44453,36,081,140901
36081140902,2644,761,810,584,226,34879,36,081,140902
36081141700,4852,1274,1571,1226,345,29167,36,081,141700
36081142900,3944,1444,1311,1071,240,35774,36,081,142900
36081143500,2350,629,694,588,106,58382,36,081,143500
36081144100,2786,973,1124,875,249,57531,36,081,144100
36081144700,3311,465,1038,583,455,35767,36,081,144700
36081145101,1072,486,367,298,69,41328,36,081,145101
36081145102,2671,615,902,584,318,43946,36,081,145102
36081145900,2754,1492,925,686,239,44667,36,081,145900
36081146300,2847,1487,1191,678,513,40280,36,081,146300
36081146700,2614,1377,1311,355,956,50227,36,081,146700
36081147100,3394,1883,1334,912,422,44602,36,081,147100
36081147900,4208,2184,1787,1210,577,61000,36,081,147900
36081148300,2976,1702,1093,923,170,70417,36,081,148300
36081150701,2974,1906,998,795,203,70625,36,081,150701
36081150702,3031,1729,1186,865,321,44750,36,081,150702
36081152901,6198,2268,2296,1725,571,50049,36,081,152901
36081152902,5919,2217,2534,2188,346,52196,36,081,152902
36081155101,2249,2137,1609,1508,101,-666666666,36,081,155101
36081155103,5165,2509,2144,1308,836,65669,36,081,155103
36081155104,3748,1286,1169,766,403,61688,36,081,155104
36081156700,1929,445,355,67,288,-666666666,36,081,156700
36081157101,8444,2193,2603,1988,615,55795,36,081,157101
36081157102,2080,378,546,353,193,41118,36,081,157102
36081157901,5389,1498,1648,1429,219,48325,36,081,157901
36081157902,4392,1189,1162,1065,97,45087,36,081,157902
36081157903,4055,1438,1134,867,267,44846,36,081,157903
36081161700,4610,1937,1508,1324,184,51842,36,081,161700
36081162100,6397,1976,1868,1190,678,46571,36,081,162100
36081990100,0,0,0,0,0,-666666666,36,081,990100
36083040100,4209,2682,1681,639,1042,27359,36,083,040100
36083040200,3871,2704,1884,715,1169,29820,36,083,040200
36083040300,2916,1866,1186,436,750,34167,36,083,040300
36083040400,2507,807,995,188,807,20347,36,083,040400
36083040500,1864,943,826,212,614,21727,36,083,040500
36081140300,2508,824,775,727,48,40474,36,081,140300
36083040600,2215,1296,646,215,431,9942,36,083,040600
36083040701,4021,2828,2076,9,2067,30650,36,083,040701
36083040702,1646,1408,528,202,326,27951,36,083,040702
36083040800,1581,1220,860,234,626,31341,36,083,040800
36083040900,3170,1991,1281,403,878,26814,36,083,040900
36083041000,4393,2257,1627,540,1087,32073,36,083,041000
36083041101,2671,2337,1301,794,507,51667,36,083,041101
36083041102,2245,1234,986,342,644,27276,36,083,041102
36103158209,3194,2201,1161,633,528,41173,36,103,158209
36103158304,7594,7022,2560,2109,451,61102,36,103,158304
36103158306,5621,5524,2001,1943,58,55536,36,103,158306
36103158309,4719,3595,1676,958,718,42303,36,103,158309
36103158310,5077,4719,1815,1433,382,51916,36,103,158310
36103158315,4336,3062,1661,1602,59,49106,36,103,158315
36103158317,5420,4778,1971,1768,203,47966,36,103,158317
36103158318,4829,4555,1693,1583,110,51743,36,103,158318
36103158319,4025,3547,1358,1275,83,47875,36,103,158319
36103158320,6319,5449,2240,1979,261,48131,36,103,158320
36103158322,1669,1451,692,673,19,67727,36,103,158322
36103158324,2632,1650,948,767,181,50625,36,103,158324
36103158325,7191,4862,2607,628,1979,53023,36,103,158325
36103158326,1279,1150,510,217,293,49184,36,103,158326
36103158327,6789,5752,2199,1933,266,44310,36,103,158327
36103158328,5073,4607,1525,1460,65,52896,36,103,158328
36103158329,1607,1547,487,396,91,52439,36,103,158329
36103158401,1222,1181,464,413,51,53859,36,103,158401
36103158402,4640,4337,1374,1299,75,53509,36,103,158402
36103158403,2365,1860,971,579,392,51765,36,103,158403
36103158407,5090,4983,1754,1481,273,60103,36,103,158407
36103158408,3657,3273,1402,1125,277,48203,36,103,158408
36103158409,3633,3185,1475,1277,198,44107,36,103,158409
36103158410,2975,2850,1955,1816,139,41237,36,103,158410
36103158411,2825,2300,798,745,53,49615,36,103,158411
36103158412,3004,2807,1046,844,202,55169,36,103,158412
36103158502,3686,2862,1399,647,752,40000,36,103,158502
36103158505,4008,3260,1325,986,339,56989,36,103,158505
36103158506,3420,3053,1092,1024,68,56404,36,103,158506
36103158509,4906,3976,1716,1270,446,37383,36,103,158509
36103158510,7485,5792,2268,2010,258,49990,36,103,158510
36103158511,6726,5725,2071,1692,379,50922,36,103,158511
36103158512,3008,2649,890,764,126,51432,36,103,158512
36103158513,2882,2484,848,759,89,41094,36,103,158513
36103158514,7794,6609,2160,1947,213,46624,36,103,158514
36103158604,5255,4444,1609,1451,158,43477,36,103,158604
36103158605,4815,4034,1509,1404,105,52466,36,103,158605
36103158606,5036,4307,1489,1258,231,43172,36,103,158606
36103158607,3160,2884,1173,898,275,58869,36,103,158607
36103158608,3495,2681,1068,771,297,46563,36,103,158608
36103158609,4880,4116,1605,1126,479,51467,36,103,158609
36103158705,4179,1015,1139,941,198,34276,36,103,158705
36103158707,1843,1716,588,559,29,52083,36,103,158707
36103158708,3588,2841,1620,1093,527,46742,36,103,158708
36103158709,3065,2922,1346,843,503,43180,36,103,158709
36061009902,3039,1838,1834,184,1650,103750,36,061,009902
36061009903,1098,541,595,0,595,119857,36,061,009903
36061010000,1735,1228,1186,221,965,75272,36,061,010000
36061010100,1457,725,948,4,944,83750,36,061,010100
36061010200,160,138,131,31,100,81007,36,061,010200
36061010300,2300,1554,1319,149,1170,82981,36,061,010300
36061010400,842,568,552,281,271,107125,36,061,010400
36061010601,7238,6584,4127,2946,1181,160946,36,061,010601
36061010602,4591,3700,2091,316,1775,93301,36,061,010602
36061010801,3033,2498,1766,598,1168,101430,36,061,010801
36061010802,4259,3946,2285,962,1323,69298,36,061,010802
36061010803,2000,1657,1095,653,442,107391,36,061,010803
36061010900,207,135,87,31,56,112000,36,061,010900
36061011000,7630,6100,3942,678,3264,103818,36,061,011000
36061011100,4720,2757,2679,297,2382,86717,36,061,011100
36061011201,985,783,517,167,350,101667,36,061,011201
36061011202,441,382,234,192,42,74000,36,061,011202
36061011203,1228,950,613,304,309,112656,36,061,011203
36061011300,102,18,50,25,25,81875,36,061,011300
36061011401,1129,1005,676,364,312,213889,36,061,011401
36061011402,2087,1723,1065,715,350,124226,36,061,011402
36061011500,3538,1727,1779,270,1509,87917,36,061,011500
36061011600,3827,2753,2102,336,1766,77295,36,061,011600
36061011700,4313,2658,2872,0,2872,107132,36,061,011700
36061011800,9054,7091,4932,1627,3305,103094,36,061,011800
36061011900,1024,420,919,0,919,24215,36,061,011900
36061012000,3103,2750,1626,1121,505,130795,36,061,012000
36061012101,2926,2172,1647,105,1542,46650,36,061,012101
36061012102,4735,3410,3118,0,3118,58776,36,061,012102
36061012200,2608,2487,1326,990,336,118990,36,061,012200
36061012400,10626,7712,5175,1254,3921,76723,36,061,012400
36061012500,2273,1197,1475,108,1367,108162,36,061,012500
36061012601,6791,6082,3805,2202,1603,79953,36,061,012601
36061012602,5076,4252,2658,999,1659,85938,36,061,012602
36061012700,6783,4963,4070,936,3134,86721,36,061,012700
36061012800,5029,4631,2342,1890,452,85625,36,061,012800
36061012901,5965,3810,3742,547,3195,93011,36,061,012901
36061012902,2380,1542,1286,298,988,56792,36,061,012902
36061013000,3581,3397,1677,1239,438,85756,36,061,013000
36061013100,2563,1695,1839,250,1589,85459,36,061,013100
36061013201,2614,1768,1476,361,1115,74854,36,061,013201
36061013202,3075,2102,1641,86,1555,69118,36,061,013202
36061013203,4717,4005,2931,404,2527,73710,36,061,013203
36061013300,6235,3754,3725,719,3006,78465,36,061,013300
36061013400,10759,9172,6116,2339,3777,104077,36,061,013400
36081000104,225,66,0,0,0,-666666666,36,081,000104
36081000200,2638,1065,824,436,388,32404,36,081,000200
36081000400,4280,973,1077,477,600,32263,36,081,000400
36081000600,4039,1142,956,527,429,37465,36,081,000600
36081000701,2694,1598,1193,614,579,100815,36,081,000701
36081000702,3205,2197,1538,339,1199,69167,36,081,000702
36081000800,3146,998,910,645,265,33623,36,081,000800
36081001000,4470,1575,987,464,523,33533,36,081,001000
36081001200,3615,1371,1139,329,810,40358,36,081,001200
36081001400,4080,1511,1193,617,576,36764,36,081,001400
36081001600,2318,672,730,470,260,48211,36,081,001600
36081001800,2599,670,817,455,362,35571,36,081,001800
36081001901,996,437,489,122,367,96754,36,081,001901
36081001902,3376,1242,1727,312,1415,94009,36,081,001902
36081001903,1514,630,670,59,611,70884,36,081,001903
36081002000,1577,449,435,223,212,40845,36,081,002000
36081002200,2226,845,713,258,455,36042,36,081,002200
36081002400,2295,770,639,319,320,31996,36,081,002400
36081002500,6637,853,3367,31,3336,19527,36,081,002500
36081002600,2133,923,648,507,141,48816,36,081,002600
36081002800,3454,1249,1107,362,745,42734,36,081,002800
36081003000,1609,929,409,274,135,33306,36,081,003000
36081003100,1125,494,489,45,444,51016,36,081,003100
36081003200,1783,692,513,325,188,32156,36,081,003200
36081003301,2370,1054,1258,58,1200,83462,36,081,003301
36081003302,1214,226,451,120,331,29968,36,081,003302
36081003400,2545,615,667,337,330,31638,36,081,003400
36081003600,3550,1160,991,391,600,35272,36,081,003600
36081003700,0,0,0,0,0,-666666666,36,081,003700
36081003800,2736,636,704,196,508,30116,36,081,003800
36081003900,1389,674,473,36,437,36543,36,081,003900
36081004001,2107,986,610,285,325,33784,36,081,004001
36081004002,1583,384,415,181,234,32577,36,081,004002
36081004200,3862,566,1112,529,583,31133,36,081,004200
36081004300,2193,371,1074,0,1074,27667,36,081,004300
36081004401,3869,682,911,373,538,32100,36,081,004401
36081004500,2970,2125,1554,1139,415,63792,36,081,004500
36081004700,3650,1343,1658,122,1536,39059,36,081,004700
36081005000,0,0,0,0,0,-666666666,36,081,005000
36081005100,1737,593,663,89,574,40282,36,081,005100
36081005200,2845,393,797,293,504,31250,36,081,005200
36081005300,5039,3103,2373,352,2021,59274,36,081,005300
36081005400,5916,1693,1891,1065,826,39776,36,081,005400
36081005500,1025,496,372,50,322,46042,36,081,005500
36081005700,4229,2165,1653,85,1568,47406,36,081,005700
36081005800,6228,2633,1900,1119,781,42929,36,081,005800
36083041200,3148,2806,1362,672,690,42910,36,083,041200
36083041300,4907,3445,1125,601,524,7063,36,083,041300
36083041400,3889,2850,1864,625,1239,48060,36,083,041400
36083051500,2538,1743,1269,411,858,32391,36,083,051500
36083051601,2946,2251,1346,481,865,35608,36,083,051601
36083051602,3739,3394,1748,962,786,52663,36,083,051602
36083051701,3396,3180,1280,919,361,27253,36,083,051701
36083051702,3361,3277,1370,840,530,36384,36,083,051702
36083051800,5608,5529,2019,1706,313,44410,36,083,051800
36083051901,4532,4353,1794,1608,186,49658,36,083,051901
36083051902,2996,2773,1133,1031,102,43700,36,083,051902
36083052002,2031,2005,689,652,37,43409,36,083,052002
36083052003,4176,3815,1859,1415,444,50802,36,083,052003
36083052004,6734,6265,2793,2064,729,53072,36,083,052004
36083052101,2277,2226,984,896,88,50781,36,083,052101
36083052102,1386,1334,583,511,72,33500,36,083,052102
36083052103,1781,1758,711,589,122,38009,36,083,052103
36083052201,4491,4333,1728,1473,255,55239,36,083,052201
36083052203,5969,5746,2457,2152,305,47570,36,083,052203
36083052204,2486,2482,890,806,84,54281,36,083,052204
36083052301,4656,4255,1858,1040,818,51145,36,083,052301
36083052303,1178,1101,476,378,98,38162,36,083,052303
36083052305,2524,2330,1100,787,313,33409,36,083,052305
36083052306,3874,3704,1525,1264,261,57050,36,083,052306
36083052402,2454,2242,753,713,40,54408,36,083,052402
36083052405,2620,2358,1171,836,335,46438,36,083,052405
36083052406,4023,3559,1896,1383,513,54983,36,083,052406
36083052407,4725,4055,1954,1540,414,67022,36,083,052407
36083052408,2463,2434,1157,916,241,57159,36,083,052408
36083052501,6257,5963,2527,2191,336,50979,36,083,052501
36083052502,5342,5022,2295,1806,489,47199,36,083,052502
36083052503,1483,1433,621,398,223,39583,36,083,052503
36083052601,3710,3648,1522,1249,273,42127,36,083,052601
36083052602,1125,1014,466,314,152,43500,36,083,052602
36083052603,2879,2845,1253,1042,211,36441,36,083,052603
36085000300,2123,1324,1100,298,802,49821,36,085,000300
36085000600,2331,1332,1278,535,743,53188,36,085,000600
36085000700,4325,1328,1997,290,1707,38617,36,085,000700
36085000800,5553,3281,1853,1494,359,49589,36,085,000800
36085000900,1875,937,733,263,470,37917,36,085,000900
36085001100,3146,1345,1095,421,674,40081,36,085,001100
36085001700,1293,650,555,285,270,40161,36,085,001700
36085001800,659,504,208,5,203,41700,36,085,001800
36085002001,2909,2052,1417,876,541,40785,36,085,002001
36085002002,3182,2321,1271,783,488,54509,36,085,002002
36103158711,5408,4431,2309,1803,506,53512,36,103,158711
36103158712,6953,5738,2056,1874,182,44690,36,103,158712
36103158713,3052,1936,931,428,503,38487,36,103,158713
36103158714,1884,1112,501,274,227,53143,36,103,158714
36103158715,4389,3539,2172,1660,512,50258,36,103,158715
36103158802,4739,4674,1876,1480,396,53625,36,103,158802
36103158803,6245,5315,2197,1917,280,50124,36,103,158803
36103158805,3725,3154,1071,999,72,44258,36,103,158805
36103158806,4477,3867,1249,1029,220,49770,36,103,158806
36103158901,3210,2617,1510,908,602,38224,36,103,158901
36103158902,4762,4555,1951,1035,916,49756,36,103,158902
36103159000,4417,4097,1895,1337,558,52491,36,103,159000
36103159103,5278,2864,1459,922,537,37025,36,103,159103
36103159106,5783,4243,1865,1071,794,47976,36,103,159106
36103159107,4632,3253,1384,1256,128,38221,36,103,159107
36103159108,7620,6123,2348,2272,76,50183,36,103,159108
36103159109,2964,2454,1012,908,104,47651,36,103,159109
36103159110,3346,2594,1486,550,936,48304,36,103,159110
36103159111,3416,3340,1005,870,135,55578,36,103,159111
36103159112,3788,3069,1393,614,779,33418,36,103,159112
36103159201,3081,2918,1239,1118,121,63462,36,103,159201
36103159203,5421,5024,1953,1775,178,46042,36,103,159203
36103159204,3762,3134,1409,1123,286,46217,36,103,159204
36103159300,1899,1791,871,776,95,71713,36,103,159300
36103159406,4716,4091,1725,1115,610,51178,36,103,159406
36103159407,8181,7348,2323,2178,145,49657,36,103,159407
36103159408,3504,2933,957,867,90,40458,36,103,159408
36103159410,7004,6433,2424,2163,261,51365,36,103,159410
36103159411,3448,3098,963,864,99,43214,36,103,159411
36103159413,4598,3778,1711,1486,225,50847,36,103,159413
36103159414,2694,2244,1095,522,573,53208,36,103,159414
36103159415,1314,1028,727,135,592,62292,36,103,159415
36103159416,5325,4299,1493,1309,184,45100,36,103,159416
36103159509,3721,3015,1279,937,342,38417,36,103,159509
36103159510,260,188,64,55,9,46250,36,103,159510
36103159511,6993,5292,2086,1570,516,37287,36,103,159511
36103158710,3962,2912,1257,920,337,51924,36,103,158710
36103159512,2293,2034,724,680,44,40530,36,103,159512
36103159513,5685,4581,1754,1577,177,42630,36,103,159513
36103159514,3311,2361,938,803,135,50491,36,103,159514
36103159515,2297,1941,726,523,203,35938,36,103,159515
36103159516,6398,5928,2020,1676,344,48407,36,103,159516
36103159517,3690,3074,990,723,267,30902,36,103,159517
36103159518,5170,4535,1636,1299,337,35074,36,103,159518
36103159602,3714,3503,1233,1163,70,61555,36,103,159602
36061013501,4609,2661,2443,111,2332,76302,36,061,013501
36061013502,5129,2890,2893,108,2785,74671,36,061,013502
36061013601,1849,1823,814,614,200,170083,36,061,013601
36061013602,6778,5244,2993,1040,1953,93217,36,061,013602
36061013603,3553,3458,1880,139,1741,66814,36,061,013603
36061013604,4004,3536,2258,748,1510,70205,36,061,013604
36061013700,6428,4716,3383,1367,2016,117771,36,061,013700
36061013800,12448,10140,6769,1985,4784,96883,36,061,013800
36061013900,10593,7247,7074,2040,5034,96977,36,061,013900
36061014000,7245,6335,4050,2172,1878,89279,36,061,014000
36061014200,4878,4113,2161,1387,774,97286,36,061,014200
36061014300,1,1,0,0,0,-666666666,36,061,014300
36061014401,4551,4047,2417,1295,1122,101912,36,061,014401
36061014402,6630,5339,3572,1206,2366,84099,36,061,014402
36061014500,6270,4273,2938,845,2093,133450,36,061,014500
36061014601,4263,3261,2536,109,2427,94118,36,061,014601
36061014602,8006,7294,4588,957,3631,92244,36,061,014602
36061014700,3162,1760,1563,216,1347,102319,36,061,014700
36061014801,2724,2366,1304,536,768,98712,36,061,014801
36061014802,6735,5148,3273,1349,1924,80839,36,061,014802
36061014900,5156,4243,2983,1151,1832,99021,36,061,014900
36061015001,2159,1890,965,551,414,121607,36,061,015001
36061015002,4545,3875,2086,1691,395,106759,36,061,015002
36061015101,3806,787,1659,36,1623,32900,36,061,015101
36061015102,6783,3556,3249,552,2697,97276,36,061,015102
36061015200,7576,4334,3579,581,2998,85382,36,061,015200
36061015301,4186,3392,2311,854,1457,119969,36,061,015301
36061015302,5614,4570,2960,1081,1879,107003,36,061,015302
36061015401,5541,4440,2985,778,2207,87717,36,061,015401
36061015402,4516,3044,2132,808,1324,65720,36,061,015402
36061015403,4483,3391,2196,791,1405,91485,36,061,015403
36061015501,5150,4722,3004,1837,1167,109500,36,061,015501
36061015502,5032,3770,2901,1682,1219,80475,36,061,015502
36061015601,5077,3619,2621,105,2516,72309,36,061,015601
36061015602,2282,840,1059,71,988,68830,36,061,015602
36061015700,9814,8454,5787,2138,3649,105112,36,061,015700
36061015801,4532,3671,2356,1093,1263,95250,36,061,015801
36061015802,4465,2673,1898,35,1863,58750,36,061,015802
36061015900,9272,7467,5088,2815,2273,101489,36,061,015900
36061016001,3290,2963,1536,1297,239,136472,36,061,016001
36061016002,3515,2326,1224,440,784,71861,36,061,016002
36061016100,6572,5578,3742,1157,2585,84940,36,061,016100
36061016200,9377,1737,4561,366,4195,40051,36,061,016200
36061016300,7528,6724,3406,1504,1902,70558,36,061,016300
36061016400,7547,2111,3183,2,3181,31507,36,061,016400
36081006100,5497,3702,2644,212,2432,60028,36,081,006100
36081006201,5681,3915,3011,2718,293,58750,36,081,006201
36081006202,5760,3382,2195,832,1363,31692,36,081,006202
36081006300,5915,3968,2656,266,2390,57038,36,081,006300
36081006501,3186,2036,1597,132,1465,52741,36,081,006501
36081006502,3796,2535,1788,212,1576,54869,36,081,006502
36081006900,3785,2493,1628,251,1377,77724,36,081,006900
36081007100,3211,1872,1699,137,1562,62349,36,081,007100
36081007300,3863,2285,2036,213,1823,60854,36,081,007300
36081007500,3982,2393,2189,461,1728,66234,36,081,007500
36081007700,1894,1033,796,104,692,60890,36,081,007700
36081007900,2661,1296,1192,360,832,54063,36,081,007900
36081008100,1226,647,566,103,463,59167,36,081,008100
36081008300,2242,979,976,126,850,47705,36,081,008300
36081008500,941,503,316,44,272,35509,36,081,008500
36081008600,2796,1334,914,614,300,37292,36,081,008600
36081008700,3536,1095,1516,0,1516,25305,36,081,008700
36081008800,3650,1819,1143,832,311,48750,36,081,008800
36081009100,2168,1628,1120,444,676,64662,36,081,009100
36081009400,2817,340,671,368,303,32354,36,081,009400
36081009500,2190,1664,841,219,622,55185,36,081,009500
36081009600,3250,568,870,678,192,35477,36,081,009600
36081009700,3812,2725,1505,377,1128,55566,36,081,009700
36081009800,2627,150,653,286,367,32455,36,081,009800
36081009900,0,0,0,0,0,-666666666,36,081,009900
36081010000,3665,927,1178,924,254,39839,36,081,010000
36081010100,2458,1812,993,330,663,40511,36,081,010100
36081010200,2771,268,739,474,265,32832,36,081,010200
36081010300,4045,3048,1897,501,1396,51084,36,081,010300
36081010400,3109,349,967,592,375,34043,36,081,010400
36081010500,4852,2851,1642,185,1457,43623,36,081,010500
36081010600,3764,358,979,674,305,35324,36,081,010600
36081010701,0,0,0,0,0,-666666666,36,081,010701
36081010800,3137,179,827,448,379,34063,36,081,010800
36081011000,2846,359,735,353,382,31580,36,081,011000
36081011100,3164,2306,1245,360,885,63340,36,081,011100
36081005900,3771,2570,1567,263,1304,57823,36,081,005900
36081011200,2275,629,711,372,339,33542,36,081,011200
36081011300,4326,3098,1750,402,1348,53539,36,081,011300
36081011400,1323,454,348,146,202,26683,36,081,011400
36081011500,2486,1926,1128,320,808,54779,36,081,011500
36081011600,1951,643,606,262,344,29620,36,081,011600
36081011700,3706,3044,1467,396,1071,53654,36,081,011700
36081011800,2398,312,641,360,281,30913,36,081,011800
36081011900,1419,840,639,114,525,41525,36,081,011900
36081012000,2485,531,591,298,293,31439,36,081,012000
36085002100,4849,2420,1901,493,1408,41264,36,085,002100
36085002700,1805,661,378,73,305,20810,36,085,002700
36085002900,4867,1111,1739,477,1262,29063,36,085,002900
36085003300,3622,1878,1353,697,656,53750,36,085,003300
36085003600,2965,1511,906,514,392,51401,36,085,003600
36085003900,2373,1645,997,195,802,49659,36,085,003900
36085004001,2996,976,1070,597,473,25482,36,085,004001
36085004002,2290,321,761,697,64,52260,36,085,004002
36085004003,3253,466,1463,81,1382,27763,36,085,004003
36085004004,3875,1536,1200,472,728,35613,36,085,004004
36085004700,2747,1847,919,727,192,33893,36,085,004700
36085005000,4061,2847,1336,974,362,54032,36,085,005000
36085005901,3180,2491,1204,763,441,47404,36,085,005901
36085005902,0,0,0,0,0,-666666666,36,085,005902
36085006400,3318,2019,1168,646,522,31282,36,085,006400
36085006700,2529,2096,1026,718,308,69700,36,085,006700
36085007001,3083,2416,1007,988,19,37500,36,085,007001
36085007002,6376,4492,1672,1346,326,38290,36,085,007002
36085007400,4494,3058,1767,1131,636,55334,36,085,007400
36085007500,4551,2471,1134,539,595,35131,36,085,007500
36085007700,1635,719,517,237,280,38750,36,085,007700
36085008100,4382,2235,1797,877,920,51009,36,085,008100
36085009601,4656,4031,1582,1033,549,53463,36,085,009601
36085009602,3193,2576,1331,715,616,41303,36,085,009602
36085009701,4331,2076,1513,901,612,54034,36,085,009701
36085009702,0,0,0,0,0,-666666666,36,085,009702
36085010500,4431,2144,1645,947,698,42154,36,085,010500
36085011201,5913,4799,1835,1388,447,47120,36,085,011201
36085011203,6237,4304,2198,1542,656,44861,36,085,011203
36085011204,233,19,66,0,66,37583,36,085,011204
36085011401,2960,1535,1318,646,672,38558,36,085,011401
36085011402,3524,2996,1278,912,366,53655,36,085,011402
36085012100,2912,2698,1196,1138,58,73077,36,085,012100
36085012200,4022,3339,1317,926,391,53259,36,085,012200
36085012500,3103,2086,1035,655,380,41384,36,085,012500
36085012804,4096,2903,1528,1054,474,48730,36,085,012804
36085012805,2534,2308,792,644,148,48452,36,085,012805
36085012806,5304,4009,2243,803,1440,33707,36,085,012806
36085013201,1347,1198,496,445,51,70795,36,085,013201
36085013203,5986,5317,2044,1617,427,49276,36,085,013203
36085013204,4809,4106,1749,1252,497,44785,36,085,013204
36085013301,1067,199,489,8,481,24301,36,085,013301
36085013302,3320,1255,983,392,591,37263,36,085,013302
36085013400,4127,3013,1416,1006,410,39549,36,085,013400
36085013800,6558,5721,2466,2203,263,54477,36,085,013800
36103159603,1171,1143,531,531,0,31688,36,103,159603
36103159604,5153,4901,1868,1740,128,61602,36,103,159604
36103159700,2046,1614,749,602,147,70968,36,103,159700
36103169701,8139,7611,3031,2873,158,69798,36,103,169701
36103169703,1572,1458,653,617,36,60604,36,103,169703
36103169705,2408,1584,956,563,393,38219,36,103,169705
36103169706,4018,3794,2151,2001,150,38905,36,103,169706
36103169800,6150,4228,1926,1152,774,31083,36,103,169800
36103169903,4755,3187,2024,1401,623,39110,36,103,169903
36103169904,1833,1748,684,507,177,46750,36,103,169904
36103169905,1046,969,469,425,44,-666666666,36,103,169905
36103169906,3603,3413,1393,1128,265,53097,36,103,169906
36103170003,2556,2540,903,860,43,43365,36,103,170003
36103170004,3192,3132,1515,1424,91,41959,36,103,170004
36103170005,2497,2463,1009,869,140,60144,36,103,170005
36103170006,1487,1467,624,544,80,43138,36,103,170006
36103170101,2058,1618,934,574,360,35357,36,103,170101
36103170203,1438,1406,644,601,43,73397,36,103,170203
36103170204,4531,4248,1826,1611,215,50057,36,103,170204
36103170205,2190,1936,1071,871,200,53160,36,103,170205
36103170206,2228,2151,1036,871,165,48056,36,103,170206
36103180300,2743,2522,1375,1273,102,72284,36,103,180300
36103190402,2315,1912,782,702,80,29816,36,103,190402
36103190403,4234,3233,1635,946,689,33696,36,103,190403
36103190404,4237,1951,924,598,326,27899,36,103,190404
36103190405,5170,3637,1647,1192,455,36862,36,103,190405
36103190502,2407,2101,1019,766,253,38333,36,103,190502
36103190503,2451,2306,1028,821,207,66176,36,103,190503
36103190504,2407,2124,826,725,101,51413,36,103,190504
36103190603,4714,4383,1871,1173,698,43736,36,103,190603
36103190604,4893,4658,1947,1700,247,52090,36,103,190604
36103190605,600,550,267,220,47,47969,36,103,190605
36103190606,3650,3467,1536,1305,231,51032,36,103,190606
36103190706,5032,3676,1925,1511,414,40147,36,103,190706
36103190708,1800,1726,890,737,153,61696,36,103,190708
36103190709,1591,1446,623,547,76,54314,36,103,190709
36103190710,1228,913,579,385,194,35000,36,103,190710
36103190711,3590,2759,1388,1126,262,46167,36,103,190711
36103190712,883,808,465,424,41,64821,36,103,190712
36103190713,1954,1712,759,718,41,75962,36,103,190713
36103190714,1822,1466,607,533,74,34875,36,103,190714
36103190801,1399,1291,680,551,129,89653,36,103,190801
36103190802,1902,1690,704,604,100,70081,36,103,190802
36103200901,920,780,483,383,100,49861,36,103,200901
36103200903,1353,1161,575,424,151,43472,36,103,200903
36003950500,3725,3687,1670,1367,303,34076,36,003,950500
36003950600,3541,3367,1448,1137,311,31494,36,003,950600
36003950700,3387,3265,1769,1373,396,35382,36,003,950700
36003950800,5897,4912,1104,783,321,5721,36,003,950800
36003950900,3634,3622,1650,1312,338,28210,36,003,950900
36003951000,3287,3260,1341,1161,180,32128,36,003,951000
36003951100,3746,3573,1691,1083,608,25532,36,003,951100
36003951201,2155,2119,945,730,215,32128,36,003,951201
36003951202,2510,2453,1036,823,213,30789,36,003,951202
36003951301,1161,1115,558,458,100,35104,36,003,951301
36003951302,2143,2107,849,720,129,35303,36,003,951302
36005000100,6600,2560,0,0,0,13038,36,005,000100
36005000200,4167,1272,1340,776,564,44345,36,005,000200
36005000400,5684,2185,2110,1549,561,48493,36,005,000400
36005001600,5917,1334,2153,259,1894,30775,36,005,001600
36005001901,1910,624,784,8,776,44875,36,005,001901
36005001902,1334,239,329,60,269,28050,36,005,001902
36005001903,0,0,0,0,0,-666666666,36,005,001903
36005001904,0,0,0,0,0,-666666666,36,005,001904
36005002001,4837,1122,1654,0,1654,21968,36,005,002001
36005002002,4768,991,1865,576,1289,41506,36,005,002002
36005002300,4517,721,1874,0,1874,23042,36,005,002300
36005002400,0,0,0,0,0,-666666666,36,005,002400
36005002500,5694,1051,1932,68,1864,21067,36,005,002500
36005002701,2672,327,1027,2,1025,17478,36,005,002701
36005002702,4504,475,1470,16,1454,21343,36,005,002702
36005002800,5030,1014,2401,324,2077,34991,36,005,002800
36005003100,1858,339,687,104,583,28045,36,005,003100
36005003300,3140,385,1208,104,1104,31618,36,005,003300
36005003500,3738,561,1374,67,1307,21409,36,005,003500
36005003700,222,15,145,0,145,31406,36,005,003700
36005003800,1169,716,333,145,188,28508,36,005,003800
36005003900,6736,1153,2241,53,2188,26933,36,005,003900
36005004001,1425,291,489,201,288,50225,36,005,004001
36005004100,5865,1069,2254,277,1977,22411,36,005,004100
36005004200,7789,1790,2875,436,2439,40076,36,005,004200
36005004300,5421,1186,2129,167,1962,27466,36,005,004300
36005004400,4401,412,1599,54,1545,30009,36,005,004400
36005004600,1854,597,697,181,516,25404,36,005,004600
36005004800,4757,398,1455,126,1329,25254,36,005,004800
36005005001,4465,243,1379,171,1208,25169,36,005,005001
36005005002,6291,368,1994,147,1847,27519,36,005,005002
36005005100,5858,935,2151,0,2151,21909,36,005,005100
36005005200,1879,198,828,66,762,22153,36,005,005200
36005005300,5142,479,1786,0,1786,17716,36,005,005300
36005005400,5354,258,1713,281,1432,22870,36,005,005400
36029002801,1250,237,484,100,384,10614,36,029,002801
36029002802,955,132,396,85,311,25303,36,029,002802
36029002900,1740,246,827,386,441,26016,36,029,002900
36029003000,2807,338,969,375,594,22898,36,029,003000
36029003100,2392,232,1185,358,827,26457,36,029,003100
36029003301,3502,237,1670,942,728,25872,36,029,003301
36029003302,2666,169,1141,414,727,21250,36,029,003302
36029003400,2903,346,1295,501,794,25028,36,029,003400
36029003501,1354,21,679,239,440,17302,36,029,003501
36029003502,1578,32,736,370,366,29621,36,029,003502
36029003600,2621,241,1190,471,719,23663,36,029,003600
36029003700,3663,431,1533,450,1083,23823,36,029,003700
36029003800,3240,524,1124,326,798,20978,36,029,003800
36029003901,913,50,507,209,298,-666666666,36,029,003901
36029004002,1185,379,579,237,342,37396,36,029,004002
36029004003,3124,253,1237,360,877,18306,36,029,004003
36029004100,4415,211,1732,730,1002,25979,36,029,004100
36029004200,3873,53,1471,652,819,27194,36,029,004200
36029004300,6703,1662,2616,1231,1385,25461,36,029,004300
36029004401,4966,219,2113,960,1153,27938,36,029,004401
36029004402,2474,200,1213,156,1057,25352,36,029,004402
36029004500,5239,3565,2281,1424,857,39911,36,029,004500
36029004601,3378,1911,1246,612,634,20183,36,029,004601
36029004701,2074,360,881,300,581,31094,36,029,004701
36029004702,4395,1567,1841,520,1321,17286,36,029,004702
36029004800,3833,3213,1575,994,581,46939,36,029,004800
36029004901,1547,1216,860,287,573,-666666666,36,029,004901
36029004902,3902,3364,1935,703,1232,38098,36,029,004902
36029005000,2160,1462,1140,479,661,38387,36,029,005000
36029005100,4389,2548,2281,1065,1216,40139,36,029,005100
36029005201,3272,2435,1400,784,616,48636,36,029,005201
36029005202,2722,900,752,336,416,12539,36,029,005202
36029005300,1572,979,444,171,273,-666666666,36,029,005300
36029005400,3865,3078,1898,927,971,45893,36,029,005400
36029005500,4271,2426,1606,347,1259,28714,36,029,005500
36029005600,3960,1469,1770,569,1201,20641,36,029,005600
36029005700,3178,1181,1102,312,790,20637,36,029,005700
36029005801,3420,1852,1356,669,687,28295,36,029,005801
36029005802,4511,2067,1725,712,1013,27442,36,029,005802
36029005900,4141,2171,1843,561,1282,24130,36,029,005900
36029006100,4816,1756,1684,634,1050,26267,36,029,006100
36029006301,4263,3486,2012,813,1199,41735,36,029,006301
36029006302,2488,2020,1127,536,591,41095,36,029,006302
36029006501,2684,2092,1393,630,763,47390,36,029,006501
36029006601,2511,1839,1136,442,694,40064,36,029,006601
36029006602,2409,1972,1296,532,764,50987,36,029,006602
36029006701,3027,2422,1607,410,1197,35206,36,029,006701
36047039500,3958,1681,1694,260,1434,29864,36,047,039500
36047039600,1910,1653,647,264,383,45852,36,047,039600
36047039700,3342,906,1353,332,1021,41079,36,047,039700
36047039800,2845,921,791,413,378,27196,36,047,039800
36047039900,4229,850,1670,259,1411,30417,36,047,039900
36047040000,2906,1354,986,417,569,32183,36,047,040000
36047040100,3203,893,1144,501,643,34683,36,047,040100
36047040200,2844,1035,909,445,464,40856,36,047,040200
36047040300,3697,916,1308,402,906,35718,36,047,040300
36047040400,2355,989,794,415,379,43304,36,047,040400
36047040500,1512,411,669,130,539,31432,36,047,040500
36047040600,3642,1351,1154,459,695,25920,36,047,040600
36047040700,0,0,0,0,0,-666666666,36,047,040700
36047040800,3485,1242,1193,712,481,48391,36,047,040800
36047040900,3829,1017,1349,188,1161,26146,36,047,040900
36047041000,2004,1480,631,313,318,49327,36,047,041000
36047041100,3050,839,1178,203,975,31500,36,047,041100
36047041200,3404,1879,1119,491,628,38801,36,047,041200
36047041300,3743,1298,1402,332,1070,43463,36,047,041300
36047041401,1541,1205,445,189,256,37927,36,047,041401
36047041402,1829,1355,751,189,562,39018,36,047,041402
36047041500,4112,1032,1461,257,1204,38777,36,047,041500
36047041600,2343,1704,722,286,436,38164,36,047,041600
36047041700,3221,999,1296,204,1092,24912,36,047,041700
36047041800,2859,2476,856,322,534,45129,36,047,041800
36047041900,3914,870,1250,150,1100,33686,36,047,041900
36047042000,1930,1710,513,283,230,36607,36,047,042000
36047042100,4239,1330,1599,250,1349,34016,36,047,042100
36047042200,3545,2139,1054,427,627,31400,36,047,042200
36047042300,3840,1684,1366,114,1252,41017,36,047,042300
36047042400,3342,1421,1136,353,783,33243,36,047,042400
36047042500,3321,1504,1088,53,1035,38381,36,047,042500
36047042600,4129,1935,1584,638,946,27025,36,047,042600
36047042700,4730,2395,1822,131,1691,41699,36,047,042700
36047042800,3789,1820,1446,597,849,36591,36,047,042800
36047042900,5205,1715,1855,80,1775,32539,36,047,042900
36047043000,3276,1557,1173,200,973,22016,36,047,043000
36047043100,4654,1914,1823,51,1772,32307,36,047,043100
36047043200,4195,1712,1369,425,944,31927,36,047,043200
36047043300,3529,472,1230,35,1195,35086,36,047,043300
36047043400,3618,1479,1239,426,813,24535,36,047,043400
36047043500,4921,789,1662,361,1301,37144,36,047,043500
36047043600,4877,2631,1581,455,1126,25673,36,047,043600
36047043700,5796,1955,1925,236,1689,32537,36,047,043700
36047043800,2532,2161,944,165,779,32229,36,047,043800
36047043900,3424,761,1211,344,867,37303,36,047,043900
36047044000,2736,2346,861,322,539,32473,36,047,044000
36005005600,2113,329,886,189,697,31771,36,005,005600
36005005902,2635,554,1109,312,797,33532,36,005,005902
36005006000,1266,341,370,56,314,25655,36,005,006000
36005006100,3985,423,2071,854,1217,44403,36,005,006100
36005006200,6995,762,2506,86,2420,25736,36,005,006200
36005006301,4741,1487,1941,329,1612,35299,36,005,006301
36005006302,0,0,0,0,0,-666666666,36,005,006302
36005006400,3949,625,1389,345,1044,35706,36,005,006400
36005006500,5394,1593,1921,55,1866,21280,36,005,006500
36005006700,6682,380,2468,100,2368,18218,36,005,006700
36005006800,3147,103,978,251,727,28632,36,005,006800
36005006900,7370,982,2844,233,2611,27435,36,005,006900
36005007000,4469,842,1285,321,964,29953,36,005,007000
36005007100,2877,399,1074,373,701,38007,36,005,007100
36005007200,6448,687,1729,400,1329,28644,36,005,007200
36005007300,4229,1133,1434,20,1414,19179,36,005,007300
36005007400,3494,1171,1330,566,764,35204,36,005,007400
36005007500,6345,1152,2235,413,1822,29647,36,005,007500
36005007600,5136,641,1780,468,1312,31054,36,005,007600
36005007700,2037,446,575,173,402,26641,36,005,007700
36005007800,7160,1746,2211,519,1692,36211,36,005,007800
36005007900,6795,737,2345,51,2294,29213,36,005,007900
36005008300,5948,910,2187,344,1843,32180,36,005,008300
36005008400,3017,814,982,710,272,36771,36,005,008400
36005008500,5416,818,2128,335,1793,25148,36,005,008500
36005008600,3757,1312,1537,273,1264,29038,36,005,008600
36005008700,6230,555,2056,65,1991,19052,36,005,008700
36005008900,2998,565,1217,97,1120,24850,36,005,008900
36005009000,3574,1228,1178,247,931,29583,36,005,009000
36005009200,6005,888,1879,476,1403,24806,36,005,009200
36005009301,5343,746,1684,114,1570,30802,36,005,009301
36005009302,579,115,0,0,0,12406,36,005,009302
36005009600,2794,599,800,271,529,30737,36,005,009600
36005009800,5019,1944,1595,673,922,42421,36,005,009800
36005011000,0,0,0,0,0,-666666666,36,005,011000
36005011502,4297,499,1348,78,1270,17628,36,005,011502
36005011701,1360,243,474,23,451,22159,36,005,011701
36005011702,0,0,0,0,0,-666666666,36,005,011702
36005011800,5645,3920,1596,974,622,31373,36,005,011800
36005011900,5399,611,1763,101,1662,21667,36,005,011900
36005012101,3072,312,941,227,714,22446,36,005,012101
36005012102,1338,123,533,12,521,17414,36,005,012102
36005012300,4371,347,1510,145,1365,25830,36,005,012300
36005012500,3859,425,1260,305,955,25980,36,005,012500
36005012701,2046,324,732,150,582,23042,36,005,012701
36005012901,4677,691,1590,90,1500,22457,36,005,012901
36005013000,1462,798,461,281,180,40588,36,005,013000
36029006702,3123,2203,2116,215,1901,37155,36,029,006702
36029006801,1235,848,696,113,583,33188,36,029,006801
36029006802,1894,1623,1312,443,869,41693,36,029,006802
36029006901,4012,1245,1469,428,1041,25650,36,029,006901
36029006903,1612,947,748,387,361,38100,36,029,006903
36029006904,2166,1251,967,315,652,24459,36,029,006904
36029007000,2698,915,1099,360,739,24704,36,029,007000
36029007102,2460,746,1094,225,869,37946,36,029,007102
36029007103,1500,678,660,51,609,26066,36,029,007103
36029007104,2690,876,1174,240,934,21045,36,029,007104
36029007202,1584,867,997,293,704,30768,36,029,007202
36029007303,7040,6096,2995,1756,1239,42397,36,029,007303
36029007304,6103,5853,2421,1920,501,57285,36,029,007304
36029007305,2561,2350,1012,991,21,39779,36,029,007305
36029007306,5583,5389,2369,2238,131,48612,36,029,007306
36029007600,2845,2791,1375,1166,209,31856,36,029,007600
36029007700,4420,4128,2183,1402,781,42445,36,029,007700
36029007800,5402,4976,2214,1656,558,32485,36,029,007800
36029007901,3037,2666,1453,905,548,40497,36,029,007901
36029007902,6689,5807,2966,2581,385,46262,36,029,007902
36029007903,3229,2797,1401,1200,201,42255,36,029,007903
36029007904,2988,2746,1350,1169,181,47525,36,029,007904
36029007905,4349,3926,2019,1581,438,39402,36,029,007905
36029008001,5390,4264,2128,1681,447,45708,36,029,008001
36029008002,5275,5050,2532,2092,440,47097,36,029,008002
36029008003,4531,4152,2344,1740,604,38491,36,029,008003
36029008101,5931,5531,2960,1923,1037,40568,36,029,008101
36029008102,4175,3942,2049,1600,449,45911,36,029,008102
36029008201,2639,2356,1259,898,361,41765,36,029,008201
36029008202,3780,3457,1780,938,842,29943,36,029,008202
36029008300,2220,1704,913,154,759,21908,36,029,008300
36029008400,2596,1976,977,806,171,37981,36,029,008400
36029008500,2419,2005,1228,899,329,51571,36,029,008500
36029008600,4659,4134,2050,1383,667,53949,36,029,008600
36029008700,4408,3776,2151,1381,770,42580,36,029,008700
36029008800,3595,3110,1823,1542,281,43696,36,029,008800
36029008900,4035,3602,1790,1362,428,46602,36,029,008900
36029009004,3789,2847,1591,1362,229,53830,36,029,009004
36029009007,7242,6405,2754,2634,120,76146,36,029,009007
36029009008,4742,3983,2464,1507,957,56309,36,029,009008
36029009009,5846,4873,2275,1631,644,68005,36,029,009009
36029009010,6435,5034,2234,1697,537,65568,36,029,009010
36029009011,2806,2425,1147,1004,143,56546,36,029,009011
36029009012,4178,3270,1942,1309,633,52437,36,029,009012
36029009104,4194,3720,1873,1725,148,48661,36,029,009104
36029009106,3278,2968,1322,1049,273,40260,36,029,009106
36029009107,6119,3874,2167,1110,1057,34727,36,029,009107
36047044100,5101,1636,1989,212,1777,33001,36,047,044100
36047044200,2699,2561,950,492,458,41354,36,047,044200
36047044300,4417,2115,2000,147,1853,38500,36,047,044300
36047044400,3458,2925,1178,441,737,27170,36,047,044400
36047044500,4393,1440,1704,298,1406,41794,36,047,044500
36047044600,1984,868,617,255,362,25078,36,047,044600
36047044700,2543,1204,925,40,885,31284,36,047,044700
36047044800,1793,1556,708,456,252,32798,36,047,044800
36047044901,2989,703,1136,19,1117,41071,36,047,044901
36047044902,0,0,0,0,0,-666666666,36,047,044902
36047045000,648,626,196,108,88,-666666666,36,047,045000
36047045200,2564,2465,827,500,327,39650,36,047,045200
36047045300,2410,1021,673,0,673,25990,36,047,045300
36047045400,1877,1455,501,239,262,37712,36,047,045400
36047045600,2183,1377,823,140,683,37692,36,047,045600
36047045800,1215,1169,481,336,145,73708,36,047,045800
36047046000,3104,1478,1059,477,582,53647,36,047,046000
36047046201,2050,1535,981,375,606,32212,36,047,046201
36047046202,1894,1718,572,319,253,36325,36,047,046202
36047046400,2717,2551,602,310,292,40448,36,047,046400
36047046800,1995,1917,526,277,249,24444,36,047,046800
36047047000,2396,2359,614,331,283,35833,36,047,047000
36047047200,2865,2821,639,266,373,36544,36,047,047200
36047047400,2258,2137,654,330,324,29500,36,047,047400
36047047600,3004,2715,864,461,403,29943,36,047,047600
36047047700,3701,2853,1705,416,1289,75668,36,047,047700
36047047800,3926,3314,1006,444,562,25182,36,047,047800
36047048000,3447,2088,990,147,843,23977,36,047,048000
36047048100,3047,1792,1257,157,1100,52233,36,047,048100
36047048200,4955,3165,2110,637,1473,43666,36,047,048200
36047048400,5566,4033,1491,354,1137,36891,36,047,048400
36047048500,2254,1372,936,121,815,42247,36,047,048500
36047048600,3152,956,754,195,559,27326,36,047,048600
36047048800,4044,1995,1472,821,651,42163,36,047,048800
36047048900,3591,699,1498,0,1498,20736,36,047,048900
36047049000,5354,2986,2245,643,1602,53874,36,047,049000
36047049100,6818,2733,2636,380,2256,31283,36,047,049100
36047049200,3240,2049,1205,472,733,59444,36,047,049200
36047049301,2288,729,1009,27,982,24911,36,047,049301
36047049302,5004,1940,2160,55,2105,33199,36,047,049302
36047049400,5681,3234,2323,965,1358,52790,36,047,049400
36047049500,2558,1841,1251,198,1053,60833,36,047,049500
36047049600,4022,1721,1379,372,1007,28555,36,047,049600
36047049700,2765,2077,1400,305,1095,64318,36,047,049700
36047049800,4011,1811,1437,448,989,36230,36,047,049800
36047049900,2030,1534,996,283,713,53870,36,047,049900
36047050001,2154,1421,868,471,397,68510,36,047,050001
36005013100,5221,1040,2098,214,1884,29556,36,005,013100
36005013200,7367,3129,2596,1662,934,56446,36,005,013200
36005013300,5785,738,2276,167,2109,32782,36,005,013300
36005013500,3633,367,1473,97,1376,33349,36,005,013500
36005013800,2853,1653,1152,712,440,42095,36,005,013800
36005014100,5752,519,2527,143,2384,27922,36,005,014100
36005014300,1647,65,649,15,634,18536,36,005,014300
36005014400,5479,1320,2393,297,2096,27230,36,005,014400
36005014500,7112,658,2355,25,2330,25674,36,005,014500
36005014701,6162,585,2026,0,2026,23152,36,005,014701
36005014702,5274,337,1893,5,1888,19452,36,005,014702
36005014900,4611,697,1484,153,1331,21301,36,005,014900
36005015100,5165,771,2027,297,1730,25076,36,005,015100
36005015200,2604,1347,962,525,437,42113,36,005,015200
36005015300,4311,249,1645,180,1465,28878,36,005,015300
36005015500,2934,217,1082,53,1029,25636,36,005,015500
36005015700,4861,753,1650,136,1514,36825,36,005,015700
36005015800,1307,759,441,208,233,50026,36,005,015800
36005015900,2115,265,772,79,693,27203,36,005,015900
36005016000,3769,2579,1488,838,650,38598,36,005,016000
36005016100,4633,246,1880,15,1865,24750,36,005,016100
36005016200,1839,974,537,250,287,50337,36,005,016200
36005016300,0,0,0,0,0,-666666666,36,005,016300
36005016400,1019,797,415,271,144,41316,36,005,016400
36005016500,1028,178,320,4,316,22525,36,005,016500
36005016600,2229,947,776,456,320,50478,36,005,016600
36005016700,3568,491,1085,63,1022,26183,36,005,016700
36005016900,1658,152,541,65,476,35037,36,005,016900
36005017100,0,0,0,0,0,-666666666,36,005,017100
36005017300,5963,763,2094,105,1989,19052,36,005,017300
36005017500,6584,586,2858,0,2858,24963,36,005,017500
36005017701,4501,506,1223,77,1146,18191,36,005,017701
36005017702,5201,876,1539,222,1317,23696,36,005,017702
36005017901,4955,888,1605,116,1489,25563,36,005,017901
36005017902,3966,657,1252,0,1252,24590,36,005,017902
36005018101,3451,182,1009,57,952,22092,36,005,018101
36005018102,5404,651,2100,55,2045,29063,36,005,018102
36005018301,4490,938,2074,432,1642,37063,36,005,018301
36005018302,3503,254,1406,60,1346,34384,36,005,018302
36005018400,3997,2531,1438,615,823,49583,36,005,018400
36005018501,2764,217,1115,15,1100,30068,36,005,018501
36005018502,6395,744,2023,86,1937,22078,36,005,018502
36005018900,8112,1631,2753,127,2626,27227,36,005,018900
36005019300,6289,479,2440,96,2344,21107,36,005,019300
36005019400,2285,845,718,306,412,43589,36,005,019400
36005019500,7097,1115,2572,84,2488,26919,36,005,019500
36029009109,3095,2129,1244,943,301,31838,36,029,009109
36029009110,5580,3024,6,0,6,3254,36,029,009110
36029009112,2781,2384,1477,440,1037,45333,36,029,009112
36029009113,6848,6024,2625,2578,47,63280,36,029,009113
36029009114,3734,3224,1518,1280,238,48018,36,029,009114
36029009115,3822,1927,1972,652,1320,20329,36,029,009115
36029009116,5273,4011,2257,1106,1151,38906,36,029,009116
36029009200,4580,2886,2217,1117,1100,34186,36,029,009200
36029009301,4696,3039,2414,1329,1085,26605,36,029,009301
36029009302,3213,1885,1252,1095,157,45308,36,029,009302
36029009401,6033,4680,2280,1607,673,29732,36,029,009401
36029009402,4574,4165,1932,1575,357,47174,36,029,009402
36029009501,5080,4559,2052,1848,204,53345,36,029,009501
36029009503,2273,1975,996,807,189,57321,36,029,009503
36029009504,4855,4438,2031,1269,762,44333,36,029,009504
36029009601,1600,1443,724,347,377,44519,36,029,009601
36029009602,5098,4102,2372,1160,1212,56301,36,029,009602
36029009701,3011,2787,1299,1003,296,40992,36,029,009701
36029009702,4537,3975,1783,1455,328,42054,36,029,009702
36029009800,1606,1579,763,525,238,40647,36,029,009800
36029009900,3547,2987,1606,1012,594,37008,36,029,009900
36029010001,3444,2740,1523,985,538,35237,36,029,010001
36029010002,4313,3961,2248,1467,781,31419,36,029,010002
36029010003,3431,2853,1527,1094,433,39413,36,029,010003
36029010101,4456,3803,2043,1824,219,40775,36,029,010101
36029010102,4007,2266,1966,673,1293,26836,36,029,010102
36029010103,3631,3001,1886,1493,393,37587,36,029,010103
36029010201,2442,1671,1129,804,325,40394,36,029,010201
36029010202,4072,1526,1399,891,508,24397,36,029,010202
36029010300,1178,607,541,366,175,27083,36,029,010300
36029010400,2172,1065,854,501,353,38143,36,029,010400
36029010500,2488,1488,1085,818,267,34392,36,029,010500
36029010600,2457,1811,1005,707,298,35750,36,029,010600
36029010700,2436,1946,1131,908,223,36890,36,029,010700
36029010803,1875,1777,777,611,166,35757,36,029,010803
36029010804,4524,4264,1876,1322,554,41201,36,029,010804
36029010805,4582,4517,2023,1558,465,40393,36,029,010805
36029010807,4600,4237,2183,1416,767,39592,36,029,010807
36029010808,3818,2941,1750,679,1071,37843,36,029,010808
36029010809,2884,2763,1225,1153,72,45039,36,029,010809
36029010901,2270,2167,1035,776,259,36006,36,029,010901
36029010902,4454,3983,2300,1162,1138,36330,36,029,010902
36029011000,1805,1602,804,624,180,35054,36,029,011000
36029011100,2118,1937,907,783,124,40019,36,029,011100
36029011201,1979,1979,748,667,81,53676,36,029,011201
36029011202,5082,4922,2325,1615,710,41528,36,029,011202
36047050002,1813,997,631,263,368,79609,36,047,050002
36047050100,3249,2388,1478,421,1057,66565,36,047,050100
36047050202,2293,1780,1070,719,351,66250,36,047,050202
36047050300,2724,2034,1362,285,1077,66212,36,047,050300
36047050401,2925,1752,1177,348,829,50625,36,047,050401
36047050402,1918,1223,942,574,368,70217,36,047,050402
36047050500,3964,1195,1840,201,1639,41307,36,047,050500
36047050600,5069,1767,1971,292,1679,38214,36,047,050600
36047050700,3189,2723,617,127,490,26545,36,047,050700
36047050801,3691,797,1303,33,1270,33820,36,047,050801
36047050803,2648,657,1085,32,1053,43608,36,047,050803
36047050804,6121,1933,2557,195,2362,45194,36,047,050804
36047050900,5777,5437,880,283,597,19702,36,047,050900
36047051001,4677,446,1724,0,1724,31420,36,047,051001
36047051002,4131,500,1694,25,1669,35903,36,047,051002
36047051100,4326,2179,1966,158,1808,51302,36,047,051100
36047051200,5823,1075,2308,166,2142,40816,36,047,051200
36047051300,5413,3465,2329,244,2085,60000,36,047,051300
36047051400,7572,1163,2763,215,2548,41793,36,047,051400
36047051500,2608,2056,1191,222,969,93318,36,047,051500
36047051601,5123,677,1936,72,1864,41930,36,047,051601
36047051602,3884,297,1487,74,1413,35625,36,047,051602
36047051700,2691,1911,1445,241,1204,102287,36,047,051700
36047051800,3128,1095,1536,465,1071,60094,36,047,051800
36047051900,5163,3615,2963,356,2607,92299,36,047,051900
36047052000,3708,1670,1333,498,835,50875,36,047,052000
36047052300,5049,2776,2224,350,1874,60909,36,047,052300
36047052500,3495,2619,1243,25,1218,31495,36,047,052500
36047052600,4521,2043,1834,337,1497,49786,36,047,052600
36047052700,6438,2785,2274,136,2138,39110,36,047,052700
36047052800,1800,1141,658,386,272,39450,36,047,052800
36047052900,3473,3225,879,113,766,19030,36,047,052900
36047053000,3862,2600,1184,241,943,30474,36,047,053000
36047053101,2487,2225,602,97,505,15201,36,047,053101
36047053102,6053,5797,1117,224,893,22289,36,047,053102
36047053200,2756,1641,1022,515,507,36346,36,047,053200
36047053300,6617,6576,1582,405,1177,21311,36,047,053300
36047053400,4659,2545,1337,329,1008,34224,36,047,053400
36047053500,3767,3533,883,93,790,19359,36,047,053500
36047053700,3749,3663,677,111,566,16441,36,047,053700
36047053800,5487,3526,2129,357,1772,47059,36,047,053800
36047053900,2517,2032,883,77,806,21882,36,047,053900
36047054200,4096,3715,1540,361,1179,38582,36,047,054200
36047054300,0,0,0,0,0,-666666666,36,047,054300
36047054400,3590,2784,1246,515,731,35168,36,047,054400
36047054500,8035,5546,2443,95,2348,21520,36,047,054500
